"Anno";"CodiceIstat";"DenominazioneComune";"LocalitDiSvolgimento";"Tipologia";"GiorniDiMercato";"Cadenza";"Periodicit";"PosteggiOccupatialimentarieNonAlimentari";"PosteggiOccupatialimentari";"PosteggiOccupatinonAlimentari";"PosteggiOccupatiproduttoriagricoli";"TotalePosteggioccupati";"PosteggiLiberialimentarieNonAlimentari";"PosteggiLiberialimentari";"PosteggiLiberinonAlimentari";"PosteggiLiberiproduttoriagricoli";"TotalePosteggiliberi";"TotalePosteggi";"Prov";""
"2014";" 001001 ";"AGLIE'";"PIAZZA CASTELLO AGLIE'";"Mercato";"mer.";"Settimanale";"Annuale";"0";"7";"11";"1";"19";"0";"0";"2";"0";"2";"21";"Torino";""
"2014";" 001004 ";"ALBIANO D'IVREA";"PIAZZA MERCATO";"Mercato";"gio.";"Settimanale";"Annuale";"0";"2";"2";"0";"4";"1";"0";"0";"1";"2";"6";"Torino";""
"2014";" 001006 ";"ALMESE";"VIA DEI NAVILI";"Mercato";"mar.";"Settimanale";"Annuale";"0";"49";"35";"6";"90";"0";"0";"0";"0";"0";"90";"Torino";""
"2014";" 001002 ";"AIRASCA";"PIAZZA SAN BARTOLOMEO";"Mercato";"mer.";"Settimanale";"Annuale";"28";"0";"0";"1";"29";"5";"0";"0";"0";"5";"34";"Torino";""
"2014";" 001003 ";"ALA DI STURA";"PIAZZA CENTRALE (SETT-GIU); PARCHEGGIO VIA CERES (LUG-AGO)";"Mercato";"gio.";"Settimanale";"Annuale";"0";"8";"21";"0";"29";"0";"0";"0";"0";"0";"29";"Torino";""
"2014";" 001018 ";"BALDISSERO TORINESE";"VIA TORINO FRAZIONE RIVO DORA";"Posteggio isolato";"mer.";"Settimanale";"Annuale";"0";"1";"0";"0";"1";"0";"0";"0";"0";"0";"1";"Torino";""
"2014";" 001008 ";"ALPIGNANO";"piazza Berlinguer";"Mercato";"mer.";"Settimanale";"Annuale";"0";"7";"4";"0";"11";"0";"5";"10";"2";"17";"28";"Torino";""
"2014";" 001015 ";"BAIRO";"PIAZZA COMUNALE";"Mercato";"mer.";"Settimanale";"Annuale";"0";"2";"2";"0";"4";"0";"1";"1";"0";"2";"6";"Torino";""
"2014";" 001020 ";"BANCHETTE";"VIA CASTELLAMONTE";"Mercato";"mer.";"Settimanale";"Annuale";"0";"4";"3";"2";"9";"0";"7";"5";"0";"12";"21";"Torino";""
"2014";" 001013 ";"AVIGLIANA";"PIAZZA DEL POPOLO";"Mercato";"dom.";"Quindicinale";"Annuale";"0";"0";"1";"0";"1";"0";"0";"24";"8";"32";"33";"Torino";""
"2014";" 001013 ";"AVIGLIANA";"VIA CAVALIERI DI VITTORIO VENETO ANG. VIA ALLIAUD";"Posteggio isolato";"lun. mar. mer. gio. ven. sab. dom.";"Settimanale";"Annuale";"0";"0";"0";"0";"0";"0";"0";"0";"1";"1";"1";"Torino";""
"2014";" 001008 ";"ALPIGNANO";"Piazza 8 Marzo";"Mercato";"sab.";"Settimanale";"Annuale";"0";"21";"48";"4";"73";"0";"4";"15";"4";"23";"96";"Torino";""
"2014";" 001013 ";"AVIGLIANA";"VIA DON BALBIANO-FRONTE CIMITERO";"Posteggio isolato";"lun. mar. mer. gio. ven. sab. dom.";"Settimanale";"Annuale";"0";"0";"1";"0";"1";"0";"0";"0";"0";"0";"1";"Torino";""
"2014";" 001014 ";"AZEGLIO";"PIAZZA MASSIMO D'AZEGLIO";"Mercato";"mar.";"Settimanale";"Annuale";"0";"2";"1";"0";"3";"0";"0";"0";"0";"0";"3";"Torino";""
"2014";" 001013 ";"AVIGLIANA";"PRESSI CIMITERO";"Posteggio isolato";"lun. mar. mer. gio. ven. sab. dom.";"Settimanale";"Annuale";"0";"0";"0";"0";"0";"0";"0";"1";"0";"1";"1";"Torino";""
"2014";" 001013 ";"AVIGLIANA";"PIAZZA DEL POPOLO";"Mercato";"gio.";"Settimanale";"Annuale";"8";"17";"60";"3";"88";"0";"1";"4";"5";"10";"98";"Torino";""
"2014";" 001007 ";"ALPETTE";"PIAZZA FORNO";"Mercato";"mar.";"Settimanale";"Annuale";"0";"0";"0";"0";"0";"8";"0";"0";"0";"8";"8";"Torino";""
"2014";" 001016 ";"BALANGERO";"PIAZZA SANDRO PERTINI";"Mercato";"mer.";"Settimanale";"Annuale";"5";"10";"0";"4";"19";"7";"2";"0";"4";"13";"32";"Torino";""
"2014";" 001019 ";"BALME";"Via capoluogo";"Mercato";"ven.";"Settimanale";"Stagionale";"0";"0";"0";"0";"0";"5";"0";"5";"0";"10";"10";"Torino";""
"2014";" 001009 ";"ANDEZENO";"PIAZZA ITALIA";"Mercato";"sab.";"Settimanale";"Annuale";"0";"7";"5";"0";"12";"0";"0";"0";"0";"0";"12";"Torino";""
"2014";" 001013 ";"AVIGLIANA";"PRESSI CIMITERO";"Posteggio isolato";"lun. mar. mer. gio. ven. sab. dom.";"Settimanale";"Annuale";"0";"0";"0";"0";"0";"0";"0";"1";"0";"1";"1";"Torino";""
"2014";" 001018 ";"BALDISSERO TORINESE";"PIAZZA IV NOVEMBRE";"Mercato";"mer.";"Settimanale";"Annuale";"0";"1";"0";"0";"1";"2";"0";"0";"0";"2";"3";"Torino";""
"2014";" 001008 ";"ALPIGNANO";"Via Rivera";"Posteggio isolato";"lun. mar. mer. gio. ven. sab. dom.";"Settimanale";"Annuale";"0";"0";"1";"0";"1";"0";"0";"0";"0";"0";"1";"Torino";""
"2014";" 001020 ";"BANCHETTE";"VIA SAMONE";"Mercato";"sab.";"Settimanale";"Annuale";"0";"3";"0";"0";"3";"0";"1";"0";"1";"2";"5";"Torino";""
"2014";" 001022 ";"BARDONECCHIA";"Piazza Statuto";"Mercato";"sab.";"Settimanale";"Annuale";"0";"11";"21";"0";"32";"7";"0";"0";"0";"7";"39";"Torino";""
"2014";" 001034 ";"BRANDIZZO";"VIA VITTIME DI BOLOGNA";"Mercato";"mar.";"Settimanale";"Annuale";"0";"1";"0";"0";"1";"0";"1";"0";"0";"1";"2";"Torino";""
"2014";" 001025 ";"BIBIANA";"PIAZZA VITTORIO EMANUELE II";"Mercato";"lun.";"Settimanale";"Annuale";"0";"10";"11";"0";"21";"0";"1";"10";"0";"11";"32";"Torino";""
"2014";" 001028 ";"BORGARO TORINESE";"VIA GRAMSCI";"Mercato";"sab.";"Settimanale";"Annuale";"0";"21";"34";"2";"57";"0";"2";"2";"0";"4";"61";"Torino";""
"2014";" 001028 ";"BORGARO TORINESE";"ZONA VILLARETTO - VIA DONATELLO ALTEZZA CIVICO 6";"Posteggio isolato";"lun. mar. mer. gio. ven. sab. dom.";"Settimanale";"Annuale";"0";"1";"0";"0";"1";"0";"0";"0";"0";"0";"1";"Torino";""
"2014";" 001037 ";"BROZOLO";"Piazza Radicati";"Mercato";"gio.";"Settimanale";"Annuale";"1";"3";"0";"1";"5";"0";"0";"1";"0";"1";"6";"Torino";""
"2014";" 001044 ";"BUSSOLENO";"Piazza Cavalieri di Vittorio Veneto";"Mercato";"lun.";"Settimanale";"Annuale";"5";"30";"100";"17";"152";"0";"0";"0";"0";"0";"152";"Torino";""
"2014";" 001032 ";"BORGONE SUSA";"PIAZZA MONTABONE";"Mercato";"ven.";"Settimanale";"Annuale";"0";"11";"11";"1";"23";"0";"4";"11";"1";"16";"39";"Torino";""
"2014";" 001039 ";"BRUSASCO";"Via Martiri della Liberta'";"Mercato";"mar.";"Settimanale";"Annuale";"0";"11";"18";"0";"29";"11";"0";"0";"0";"11";"40";"Torino";""
"2014";" 001041 ";"BURIASCO";"PIAZZA GONNET";"Mercato";"mar.";"Settimanale";"Annuale";"0";"2";"0";"0";"2";"2";"0";"0";"0";"2";"4";"Torino";""
"2014";" 001028 ";"BORGARO TORINESE";"BORGARO TORINESE - VIA CIRIE'";"Mercato";"gio.";"Settimanale";"Annuale";"0";"11";"14";"1";"26";"0";"2";"2";"1";"5";"31";"Torino";""
"2014";" 001030 ";"BORGOFRANCO D'IVREA";"PIAZZA DEL MERCATO/VIA MARCONI";"Mercato";"sab.";"Settimanale";"Annuale";"0";"6";"4";"0";"10";"0";"2";"8";"2";"12";"22";"Torino";""
"2014";" 001034 ";"BRANDIZZO";"PIAZZA CARLO TEMPIA";"Mercato";"gio.";"Settimanale";"Annuale";"0";"7";"1";"1";"9";"0";"0";"0";"0";"0";"9";"Torino";""
"2014";" 001024 ";"BEINASCO";"PIAZZA Sandro PERTINI";"Mercato";"gio.";"Settimanale";"Annuale";"0";"27";"43";"7";"77";"0";"0";"0";"1";"1";"78";"Torino";""
"2014";" 001034 ";"BRANDIZZO";"PIAZZA CARLO TEMPIA";"Mercato";"sab.";"Settimanale";"Annuale";"0";"9";"5";"1";"15";"0";"0";"2";"0";"2";"17";"Torino";""
"2014";" 001035 ";"BRICHERASIO";"PIAZZA CASTELVECCHIO";"Mercato";"gio.";"Settimanale";"Annuale";"0";"11";"11";"10";"32";"0";"0";"5";"0";"5";"37";"Torino";""
"2014";" 001031 ";"BORGOMASINO";"Piazza Modesto Pompei";"Mercato";"mar.";"Settimanale";"Annuale";"0";"5";"3";"0";"8";"0";"0";"0";"0";"0";"8";"Torino";""
"2014";" 001024 ";"BEINASCO";"LARGO TORINO";"Mercato";"gio.";"Settimanale";"Annuale";"0";"1";"0";"3";"4";"0";"9";"19";"0";"28";"32";"Torino";""
"2014";" 001030 ";"BORGOFRANCO D'IVREA";"FRAZIONE BAIO DORA - VIA PRESBITERO";"Mercato";"mar.";"Quindicinale";"Annuale";"0";"1";"1";"0";"2";"0";"0";"0";"0";"0";"2";"Torino";""
"2014";" 001038 ";"BRUINO";"PIAZZA DELLA PACE";"Mercato";"lun.";"Settimanale";"Annuale";"0";"16";"35";"4";"55";"0";"1";"4";"3";"8";"63";"Torino";""
"2014";" 001021 ";"BARBANIA";"PIAZZA UMBERTOIï¾°";"Mercato";"mar.";"Settimanale";"Annuale";"0";"3";"2";"0";"5";"0";"4";"7";"2";"13";"18";"Torino";""
"2014";" 001026 ";"BOBBIO PELLICE";"p.zza caduti per la liberta'";"Mercato";"mar.";"Settimanale";"Annuale";"0";"3";"4";"1";"8";"1";"0";"4";"5";"10";"18";"Torino";""
"2014";" 001028 ";"BORGARO TORINESE";"VIA GRAMSCI";"Mercato";"mar.";"Settimanale";"Annuale";"0";"11";"24";"2";"37";"0";"2";"1";"1";"4";"41";"Torino";""
"2014";" 001036 ";"BROSSO";"Via Cairoli";"Mercato";"mar.";"Settimanale";"Annuale";"0";"3";"2";"0";"5";"0";"0";"0";"0";"0";"5";"Torino";""
"2014";" 001028 ";"BORGARO TORINESE";"VIA LIGURIA P.LE ANTISTANTE STRADA DEL FRANCESE";"Posteggio isolato";"lun. mar. mer. gio. ven. sab. dom.";"Settimanale";"Annuale";"0";"1";"0";"0";"1";"0";"0";"0";"0";"0";"1";"Torino";""
"2014";" 001033 ";"BOSCONERO";"Piazza Martiri della Liberta' n.1 - Area Mercatale";"Mercato";"gio.";"Settimanale";"Annuale";"0";"8";"6";"0";"14";"0";"0";"1";"1";"2";"16";"Torino";""
"2014";" 001043 ";"BUSANO";"piazza san tommaso - via igonetti";"Mercato";"lun.";"Settimanale";"Annuale";"0";"4";"7";"0";"11";"0";"0";"0";"0";"0";"11";"Torino";""
"2014";" 001024 ";"BEINASCO";"VIA DANILO DOLCI";"Mercato";"gio.";"Settimanale";"Annuale";"0";"25";"38";"2";"65";"0";"5";"9";"2";"16";"81";"Torino";""
"2014";" 001022 ";"BARDONECCHIA";"Piazza della fiera";"Mercato";"gio.";"Settimanale";"Annuale";"0";"7";"15";"0";"22";"10";"0";"0";"0";"10";"32";"Torino";""
"2014";" 001028 ";"BORGARO TORINESE";"VIA LANZO CONTROVIALE DIREZIONE TORINO - CASELLE";"Posteggio isolato";"lun. mar. mer. gio. ven. sab. dom.";"Settimanale";"Annuale";"0";"1";"0";"0";"1";"0";"0";"0";"0";"0";"1";"Torino";""
"2014";" 001037 ";"BROZOLO";"Piazza Radicati";"Mercato";"gio.";"Settimanale";"Annuale";"3";"0";"1";"1";"5";"0";"0";"1";"0";"1";"6";"Torino";""
"2014";" 001026 ";"BOBBIO PELLICE";"via maestra (ala comunale)";"Mercato";"mar. sab. dom.";"Settimanale";"Stagionale";"0";"0";"0";"3";"3";"0";"0";"0";"3";"3";"6";"Torino";""
"2014";" 001028 ";"BORGARO TORINESE";"VIA GALILEI-ROTONDA VIA RIVAROLO";"Posteggio isolato";"lun. mar. mer. gio. ven. sab. dom.";"Settimanale";"Annuale";"0";"1";"0";"0";"1";"0";"0";"0";"0";"0";"1";"Torino";""
"2014";" 001045 ";"BUTTIGLIERA ALTA";"PIAZZA DONATORI DI SANGUE";"Mercato";"mar.";"Settimanale";"Annuale";"0";"2";"0";"1";"3";"0";"1";"3";"0";"4";"7";"Torino";""
"2014";" 001070 ";"CAVOUR";"PIAZZA SFORZINI";"Mercato";"mar.";"Settimanale";"Annuale";"0";"18";"49";"45";"112";"0";"0";"0";"0";"0";"112";"Torino";""
"2014";" 001073 ";"CERESOLE REALE";"PIAN DELLA BALMA'";"Mercato";"mar.";"Settimanale";"Stagionale";"2";"0";"10";"3";"15";"0";"0";"0";"0";"0";"15";"Torino";""
"2014";" 001045 ";"BUTTIGLIERA ALTA";"CORSO TORINO - ZONA ARTIGIANALE";"Mercato";"sab.";"Settimanale";"Annuale";"0";"15";"18";"3";"36";"0";"2";"12";"0";"14";"50";"Torino";""
"2014";" 001048 ";"CAMBIANO";"PIAZZA G. GROSSO - VIA CAVOUR - VIA BORGARELLI - VIA FERRERO";"Mercato";"lun.";"Settimanale";"Annuale";"0";"12";"31";"4";"47";"0";"2";"2";"1";"5";"52";"Torino";""
"2014";" 001063 ";"CASELLE TORINESE";"VIA BORGARO ANGOLO VIA BUONARROTI";"Mercato";"ven.";"Settimanale";"Annuale";"0";"6";"6";"2";"14";"0";"7";"9";"6";"22";"36";"Torino";""
"2014";" 001046 ";"CAFASSE";"PIAZZA CAV. PEINETTI";"Mercato";"sab.";"Settimanale";"Annuale";"0";"3";"1";"0";"4";"0";"0";"2";"1";"3";"7";"Torino";""
"2014";" 001059 ";"CARMAGNOLA";"P/ZZA MARTIRI";"Mercato";"gio.";"Settimanale";"Annuale";"0";"3";"0";"2";"5";"0";"0";"0";"0";"0";"5";"Torino";""
"2014";" 001060 ";"CASALBORGONE";"piazza vittorio emanuele II - tettoia";"Posteggio isolato";"sab. dom.";"Settimanale";"Annuale";"0";"0";"0";"1";"1";"0";"0";"0";"0";"0";"1";"Torino";""
"2014";" 001056 ";"CARAVINO";"PIAZZA MARCONI";"Mercato";"sab.";"Settimanale";"Annuale";"0";"3";"2";"2";"7";"0";"0";"0";"0";"0";"7";"Torino";""
"2014";" 001066 ";"CASTELLAMONTE";"Piazzale Nenni";"Mercato";"ven.";"Settimanale";"Annuale";"0";"2";"0";"8";"10";"0";"0";"0";"10";"10";"20";"Torino";""
"2014";" 001062 ";"CASELETTE";"Piazza CAJS";"Mercato";"lun.";"Settimanale";"Annuale";"0";"5";"7";"1";"13";"0";"2";"2";"1";"5";"18";"Torino";""
"2014";" 001079 ";"CHIESANUOVA";"NUOVA AREA MERCATALE";"Mercato";"mer.";"Settimanale";"Annuale";"0";"2";"1";"0";"3";"0";"0";"0";"0";"0";"3";"Torino";""
"2014";" 001059 ";"CARMAGNOLA";"VIA TORINO ANGOLO VIA CASTAGNOLE";"Mercato";"lun. mar. mer. gio. ven. sab. dom.";"Settimanale";"Annuale";"0";"1";"0";"0";"1";"0";"0";"0";"1";"1";"2";"Torino";""
"2014";" 001045 ";"BUTTIGLIERA ALTA";"P.ZZA JOUGNE";"Mercato";"mer.";"Settimanale";"Annuale";"0";"6";"3";"2";"11";"0";"4";"20";"0";"24";"35";"Torino";""
"2014";" 001072 ";"CERES";"PIAZZA GRANDE TORINO - VIA G. MARCONI";"Mercato";"lun.";"Settimanale";"Annuale";"0";"6";"18";"1";"25";"0";"0";"0";"0";"0";"25";"Torino";""
"2014";" 001078 ";"CHIERI";"PIAZZALE QUARINI";"Mercato";"mar.";"Settimanale";"Annuale";"0";"2";"8";"28";"38";"0";"3";"3";"13";"19";"57";"Torino";""
"2014";" 001059 ";"CARMAGNOLA";"P/ZZA MARTIRI-P/ZZA MAZZINI-VIA VALOBRA-VIA BOBBA";"Mercato";"mer.";"Settimanale";"Annuale";"0";"57";"156";"44";"257";"0";"9";"0";"6";"15";"272";"Torino";""
"2014";" 001065 ";"CASTAGNOLE PIEMONTE";"Piazza Cesare Battisti";"Mercato";"ven.";"Settimanale";"Annuale";"0";"8";"11";"1";"20";"0";"0";"0";"0";"0";"20";"Torino";""
"2014";" 001066 ";"CASTELLAMONTE";"Piazza F. Romano - Via G.Buffa";"Mercato";"lun.";"Settimanale";"Annuale";"0";"26";"91";"5";"122";"0";"0";"8";"3";"11";"133";"Torino";""
"2014";" 001059 ";"CARMAGNOLA";"P/ZZA MARTIRI - VIA VALOBRA";"Mercato";"sab.";"Settimanale";"Annuale";"0";"33";"40";"24";"97";"0";"1";"0";"0";"1";"98";"Torino";""
"2014";" 001047 ";"CALUSO";"PIAZZA ACTIS PERINETTI MARIO";"Mercato";"lun.";"Settimanale";"Annuale";"0";"24";"79";"9";"112";"0";"1";"0";"0";"1";"113";"Torino";""
"2014";" 001059 ";"CARMAGNOLA";"PIAZZA CONCORDIA";"Mercato";"lun. mar. mer. gio. ven. sab. dom.";"Settimanale";"Annuale";"0";"0";"0";"0";"0";"0";"3";"0";"3";"6";"6";"Torino";""
"2014";" 001071 ";"CERCENASCO";"piazza del Municipio";"Mercato";"mer.";"Settimanale";"Annuale";"0";"0";"0";"0";"0";"0";"5";"12";"4";"21";"21";"Torino";""
"2014";" 001055 ";"CAPRIE";"Piazza Matteotti";"Mercato";"mar.";"Settimanale";"Annuale";"0";"3";"1";"1";"5";"0";"0";"0";"0";"0";"5";"Torino";""
"2014";" 001063 ";"CASELLE TORINESE";"PIAZZA FALCONE";"Mercato";"lun.";"Settimanale";"Annuale";"0";"22";"83";"4";"109";"0";"0";"0";"0";"0";"109";"Torino";""
"2014";" 001069 ";"CAVAGNOLO";"PIAZZA VITTORIO VENETO";"Mercato";"sab.";"Settimanale";"Annuale";"0";"6";"1";"0";"7";"0";"1";"1";"1";"3";"10";"Torino";""
"2014";" 001049 ";"CAMPIGLIONE-FENILE";"piazza s. giovanni";"Posteggio isolato";"sab.";"Settimanale";"Annuale";"0";"1";"0";"0";"1";"0";"0";"0";"0";"0";"1";"Torino";""
"2014";" 001046 ";"CAFASSE";"PIAZZA CUBITO";"Mercato";"mer.";"Settimanale";"Annuale";"0";"10";"13";"2";"25";"0";"0";"0";"1";"1";"26";"Torino";""
"2014";" 001048 ";"CAMBIANO";"VIA GAUDE - AREA CIMITERIALE";"Posteggio isolato";"lun. mar. mer. gio. ven. sab. dom.";"Settimanale";"Stagionale";"1";"0";"0";"0";"1";"0";"0";"0";"0";"0";"1";"Torino";""
"2014";" 001051 ";"CANDIOLO";"Piazza Riccardo Sella e Vie Limitrofe";"Mercato";"ven.";"Settimanale";"Annuale";"0";"20";"25";"7";"52";"6";"0";"0";"0";"6";"58";"Torino";""
"2014";" 001054 ";"CANTOIRA";"VIA DELLA CHIESA - ANGOLO VIA I. PEROTTO";"Mercato";"mar.";"Settimanale";"Annuale";"1";"17";"28";"2";"48";"0";"0";"0";"0";"0";"48";"Torino";""
"2014";" 001058 ";"CARIGNANO";"PIAZZE SAVOIA-CARLO ALBERTO-LIBERAZIONE-SAN GIOVANNI";"Mercato";"gio.";"Settimanale";"Annuale";"0";"28";"52";"7";"87";"0";"2";"5";"3";"10";"97";"Torino";""
"2014";" 001060 ";"CASALBORGONE";"Piazza Vittorio Emanuele II -";"Mercato";"lun.";"Settimanale";"Annuale";"0";"6";"10";"2";"18";"0";"1";"9";"1";"11";"29";"Torino";""
"2014";" 001067 ";"CASTELNUOVO NIGRA";"PIAZZA MARTIRI";"Mercato";"dom.";"Settimanale";"Annuale";"0";"6";"6";"0";"12";"0";"0";"0";"0";"0";"12";"Torino";""
"2014";" 001078 ";"CHIERI";"PIAZZA EUROPA";"Mercato";"ven.";"Settimanale";"Annuale";"0";"34";"57";"40";"131";"0";"3";"1";"13";"17";"148";"Torino";""
"2014";" 001078 ";"CHIERI";"PIAZZA EUROPA";"Mercato";"mar.";"Settimanale";"Annuale";"0";"45";"127";"0";"172";"0";"4";"2";"0";"6";"178";"Torino";""
"2014";" 001077 ";"CHIAVERANO";"PIAZZA OMBRE 1";"Mercato";"mer.";"Settimanale";"Annuale";"0";"2";"1";"0";"3";"0";"1";"0";"0";"1";"4";"Torino";""
"2014";" 001048 ";"CAMBIANO";"VIA CAVALIERI DI VITTORIO VENETO";"Posteggio isolato";"lun. mar. mer. gio. ven. sab. dom.";"Settimanale";"Stagionale";"0";"0";"0";"0";"0";"0";"1";"0";"0";"1";"1";"Torino";""
"2014";" 001074 ";"CESANA TORINESE";"VIA ORTIGARA - PIAZZALE MERCATO";"Mercato";"gio.";"Settimanale";"Annuale";"0";"4";"6";"9";"19";"0";"3";"3";"0";"6";"25";"Torino";""
"2014";" 001075 ";"CHIALAMBERTO";"PIAZZA DEL MERCATO";"Mercato";"sab.";"Settimanale";"Stagionale";"0";"15";"28";"1";"44";"1";"2";"4";"2";"9";"53";"Torino";""
"2014";" 001078 ";"CHIERI";"PIAZZA DANTE";"Mercato";"sab.";"Settimanale";"Annuale";"0";"32";"61";"39";"132";"0";"3";"0";"9";"12";"144";"Torino";""
"2014";" 001082 ";"CHIVASSO";"PIAZZA D'ARMI SUD/FORO BOARIO";"Mercato";"sab.";"Settimanale";"Annuale";"0";"39";"48";"71";"158";"0";"1";"0";"7";"8";"166";"Torino";""
"2014";" 001082 ";"CHIVASSO";"Piazzale Lucio Libertini";"Posteggio isolato";"lun. mar. mer. gio. ven. sab. dom.";"Settimanale";"Annuale";"0";"1";"0";"0";"1";"0";"0";"0";"0";"0";"1";"Torino";""
"2014";" 001086 ";"CIRIE'";"PIAZZA CADUTI SUL LAVORO";"Mercato";"mar.";"Settimanale";"Annuale";"0";"8";"12";"4";"24";"0";"0";"0";"0";"0";"24";"Torino";""
"2014";" 001090 ";"COLLEGNO";"PIAZZA TORELLO";"Mercato";"sab.";"Settimanale";"Annuale";"3";"30";"23";"1";"57";"26";"0";"0";"1";"27";"84";"Torino";""
"2014";" 001113 ";"GERMAGNANO";"VIALE CONSOLE";"Mercato";"sab.";"Settimanale";"Annuale";"0";"4";"0";"2";"6";"0";"0";"3";"0";"3";"9";"Torino";""
"2014";" 001082 ";"CHIVASSO";"INTERNO FORO BOARIO (cadenza mensile)";"Mercato";"dom.";"Quindicinale";"Annuale";"0";"0";"15";"0";"15";"0";"0";"25";"0";"25";"40";"Torino";""
"2014";" 001086 ";"CIRIE'";"C.SO NAZIONI UNITE - PIAZZA CASTELLO LATO NORD E SUD";"Mercato";"ven.";"Settimanale";"Annuale";"0";"64";"192";"24";"280";"0";"0";"0";"0";"0";"280";"Torino";""
"2014";" 001087 ";"CLAVIERE";"CLAVIERE VIA TORINO 1";"Mercato";"ven.";"Settimanale";"Stagionale";"0";"2";"2";"2";"6";"0";"1";"6";"1";"8";"14";"Torino";""
"2014";" 001090 ";"COLLEGNO";"P.ZZA UNITA' D'ITALIA";"Mercato";"mar.";"Settimanale";"Annuale";"0";"5";"2";"0";"7";"23";"0";"0";"4";"27";"34";"Torino";""
"2014";" 001082 ";"CHIVASSO";"C.so G.Ferraris ang. Via Togliatti";"Posteggio isolato";"lun. mar. mer. gio. ven. sab.";"Settimanale";"Annuale";"0";"1";"0";"0";"1";"0";"0";"0";"0";"0";"1";"Torino";""
"2014";" 001090 ";"COLLEGNO";"CORSO FRANCIA";"Mercato";"mer.";"Settimanale";"Annuale";"2";"61";"136";"7";"206";"2";"0";"0";"2";"4";"210";"Torino";""
"2014";" 001090 ";"COLLEGNO";"SAVONERA";"Mercato";"lun.";"Settimanale";"Annuale";"0";"0";"0";"0";"0";"12";"0";"0";"0";"12";"12";"Torino";""
"2014";" 001099 ";"DRUENTO";"C.SO CARLO BRERO";"Mercato";"mer.";"Settimanale";"Annuale";"0";"14";"23";"3";"40";"0";"0";"7";"0";"7";"47";"Torino";""
"2014";" 001108 ";"FRASSINETTO";"VIA ROMA";"Mercato";"dom.";"Settimanale";"Annuale";"0";"2";"2";"0";"4";"0";"1";"1";"2";"4";"8";"Torino";""
"2014";" 001099 ";"DRUENTO";"C.SO CARLO BRERO";"Mercato";"sab.";"Settimanale";"Annuale";"0";"13";"15";"2";"30";"0";"4";"7";"0";"11";"41";"Torino";""
"2014";" 001080 ";"CHIOMONTE";"Piazza Balb de Roche Brune";"Mercato";"gio.";"Settimanale";"Annuale";"0";"5";"1";"0";"6";"0";"0";"0";"0";"0";"6";"Torino";""
"2014";" 001101 ";"FAVRIA";"PIAZZA REPUBBLICA, C.SO MATTEOTTI, VIA DEL PORTONE, PIAZZA MARTIRI";"Mercato";"mar.";"Settimanale";"Annuale";"0";"8";"20";"8";"36";"0";"2";"11";"0";"13";"49";"Torino";""
"2014";" 001109 ";"FRONT";"Via Perino piazzale antistante il Campo Sportivo";"Mercato";"dom.";"Settimanale";"Annuale";"0";"0";"0";"0";"0";"0";"0";"50";"0";"50";"50";"Torino";""
"2014";" 001090 ";"COLLEGNO";"VIA PASUBIO";"Mercato";"ven.";"Settimanale";"Annuale";"0";"42";"56";"5";"103";"5";"0";"0";"1";"6";"109";"Torino";""
"2014";" 001082 ";"CHIVASSO";"AREA CHIND POSTEGGIO STRADA PER CALUSO";"Posteggio isolato";"lun. mar. mer. gio. ven. sab. dom.";"Settimanale";"Annuale";"0";"1";"0";"0";"1";"0";"0";"0";"0";"0";"1";"Torino";""
"2014";" 001098 ";"CUORGNE'";"PIAZZE: MARTIRI-MORGANDO-PINELLI-BOETTO-VIA ARDUINO-VIA GARIBALDI";"Mercato";"gio.";"Settimanale";"Annuale";"0";"32";"158";"8";"198";"0";"5";"11";"1";"17";"215";"Torino";""
"2014";" 001103 ";"FENESTRELLE";"Viale Martiri della Liberta'";"Mercato";"dom.";"Settimanale";"Annuale";"0";"3";"11";"2";"16";"0";"0";"0";"1";"1";"17";"Torino";""
"2014";" 001104 ";"FIANO";"PIAZZA XXV APRILE, 1";"Mercato";"gio.";"Settimanale";"Annuale";"0";"8";"8";"0";"16";"0";"3";"0";"1";"4";"20";"Torino";""
"2014";" 001082 ";"CHIVASSO";"CENTRO STORICO/P.ZZA D'ARMI NORD E SUD/FORO BOARIO/V.LE MATTEOTTI";"Mercato";"mer.";"Settimanale";"Annuale";"0";"62";"238";"74";"374";"0";"5";"3";"5";"13";"387";"Torino";""
"2014";" 001082 ";"CHIVASSO";"VIA FAVORITA (PRESSO CIMITERO)";"Posteggio isolato";"lun. mar. mer. gio. ven. sab. dom.";"Settimanale";"Annuale";"0";"0";"1";"0";"1";"0";"0";"0";"0";"0";"1";"Torino";""
"2014";" 001105 ";"FIORANO CANAVESE";"VIA IVREA";"Mercato";"mar.";"Settimanale";"Annuale";"0";"1";"1";"0";"2";"0";"0";"0";"0";"0";"2";"Torino";""
"2014";" 001109 ";"FRONT";"PIAZZA IV NOVEMBRE";"Mercato";"mer.";"Settimanale";"Annuale";"0";"2";"1";"0";"3";"0";"1";"1";"0";"2";"5";"Torino";""
"2014";" 001089 ";"COAZZE";"piazza I Maggio - Piazza Cordero di Pamparato";"Mercato";"ven.";"Settimanale";"Annuale";"0";"11";"13";"7";"31";"0";"0";"6";"0";"6";"37";"Torino";""
"2014";" 001097 ";"CUMIANA";"PIAZZA MARTIRI III APRILE";"Mercato";"ven.";"Settimanale";"Annuale";"0";"17";"39";"0";"56";"0";"0";"2";"2";"4";"60";"Torino";""
"2014";" 001103 ";"FENESTRELLE";"centro cittï¿½";"Posteggio isolato";"dom.";"Settimanale";"Stagionale";"0";"1";"0";"0";"1";"0";"0";"0";"0";"0";"1";"Torino";""
"2014";" 001090 ";"COLLEGNO";"PIAZZA DELLA CONCORDIA";"Mercato";"gio.";"Settimanale";"Annuale";"2";"32";"55";"3";"92";"1";"0";"0";"1";"2";"94";"Torino";""
"2014";" 001106 ";"FOGLIZZO";"PIAZZA TORINIO";"Mercato";"ven.";"Settimanale";"Annuale";"0";"8";"8";"2";"18";"0";"3";"5";"1";"9";"27";"Torino";""
"2014";" 001115 ";"GIAVENO";"CENTRO";"Mercato";"sab.";"Settimanale";"Annuale";"0";"22";"93";"28";"143";"0";"0";"12";"0";"12";"155";"Torino";""
"2014";" 001082 ";"CHIVASSO";"VIA FAVORITA c/o Cimitero";"Posteggio isolato";"lun. mar. mer. gio. ven. sab. dom.";"Settimanale";"Annuale";"0";"0";"1";"0";"1";"0";"0";"0";"0";"0";"1";"Torino";""
"2014";" 001082 ";"CHIVASSO";"CORSO G. FERRARIS LATO DX INGRESSO PRINCIPALE OSPEDALE";"Posteggio isolato";"lun. mar. mer. gio. ven. sab. dom.";"Settimanale";"Annuale";"0";"0";"1";"0";"1";"0";"0";"0";"0";"0";"1";"Torino";""
"2014";" 001082 ";"CHIVASSO";"VIA B. BRADAC";"Mercato";"mar.";"Settimanale";"Annuale";"5";"0";"0";"0";"5";"12";"0";"0";"0";"12";"17";"Torino";""
"2014";" 001082 ";"CHIVASSO";"Via dei Carabinieri";"Posteggio isolato";"lun. mar. mer. gio. ven. sab. dom.";"Settimanale";"Annuale";"0";"1";"0";"0";"1";"0";"0";"0";"0";"0";"1";"Torino";""
"2014";" 001086 ";"CIRIE'";"VIA ROBASSOMERO/VIA DELLA REPUBBLICA";"Posteggio isolato";"lun. mar. mer. gio. ven. sab. dom.";"Settimanale";"Stagionale";"0";"1";"0";"0";"1";"0";"0";"0";"0";"0";"1";"Torino";""
"2014";" 001086 ";"CIRIE'";"PIAZZA VITTIME DELL'I.P.C.A.";"Posteggio isolato";"lun. mar. mer. gio. ven. sab. dom.";"Settimanale";"Stagionale";"0";"1";"0";"0";"1";"0";"0";"0";"0";"0";"1";"Torino";""
"2014";" 001094 ";"CORIO";"VIA PIANO AUDI N. 8";"Mercato";"lun.";"Settimanale";"Annuale";"0";"6";"8";"3";"17";"9";"0";"0";"0";"9";"26";"Torino";""
"2014";" 001112 ";"GASSINO TORINESE";"VIA FORATELLA";"Mercato";"gio. sab.";"Settimanale";"Annuale";"0";"52";"68";"22";"142";"0";"4";"40";"2";"46";"188";"Torino";""
"2014";" 001082 ";"CHIVASSO";"PIAZZA D'ARMI SUD";"Posteggio isolato";"lun. mar. mer. gio. ven. sab. dom.";"Settimanale";"Annuale";"0";"1";"0";"0";"1";"0";"0";"0";"0";"0";"1";"Torino";""
"2014";" 001092 ";"COLLERETTO GIACOSA";"Piazza Guido Rossa";"Mercato";"mar.";"Settimanale";"Annuale";"1";"3";"1";"1";"6";"0";"0";"0";"0";"0";"6";"Torino";""
"2014";" 001093 ";"CONDOVE";"Piazza Martiri Libertï¿½, Viale Bauchiero, Via Battisti, Via Iï¿½ Maggio";"Mercato";"mer.";"Settimanale";"Annuale";"0";"38";"64";"5";"107";"0";"2";"0";"1";"3";"110";"Torino";""
"2014";" 001082 ";"CHIVASSO";"PIAZZALE LUCIO LIBERTINI";"Posteggio isolato";"lun. mar. mer. gio. ven. sab. dom.";"Settimanale";"Annuale";"0";"1";"0";"0";"1";"0";"0";"0";"0";"0";"1";"Torino";""
"2014";" 001082 ";"CHIVASSO";"PIAZZALE DAC 2";"Posteggio isolato";"lun. mar. mer. gio. ven. sab. dom.";"Settimanale";"Annuale";"0";"1";"0";"0";"1";"0";"0";"0";"0";"0";"1";"Torino";""
"2014";" 001082 ";"CHIVASSO";"AREA CHIND POSTEGGIO STRADA PER CALUSO";"Posteggio isolato";"lun. mar. mer. gio. ven. sab. dom.";"Settimanale";"Annuale";"0";"1";"0";"0";"1";"0";"0";"0";"0";"0";"1";"Torino";""
"2014";" 001102 ";"FELETTO";"PIAZZALE VIA GHIONE";"Mercato";"ven.";"Settimanale";"Annuale";"0";"9";"6";"0";"15";"6";"0";"0";"1";"7";"22";"Torino";""
"2014";" 001107 ";"FORNO CANAVESE";"PIAZZA EX AREA OBERT";"Mercato";"sab.";"Settimanale";"Annuale";"1";"7";"8";"1";"17";"1";"1";"1";"0";"3";"20";"Torino";""
"2014";" 001110 ";"FROSSASCO";"PIAZZA CAVALIERI DI VITTORIO VENETO";"Mercato";"gio.";"Settimanale";"Annuale";"0";"5";"5";"2";"12";"0";"0";"0";"0";"0";"12";"Torino";""
"2014";" 001086 ";"CIRIE'";"PIAZZA CASTELLO LATO NORD";"Posteggio isolato";"lun. mar. mer. gio. ven. sab. dom.";"Settimanale";"Stagionale";"0";"1";"0";"0";"1";"0";"0";"0";"0";"0";"1";"Torino";""
"2014";" 001102 ";"FELETTO";"p.zza Aprato";"Mercato";"mer.";"Settimanale";"Annuale";"0";"1";"0";"0";"1";"0";"1";"0";"0";"1";"2";"Torino";""
"2014";" 001115 ";"GIAVENO";"centro storico";"Mercato";"dom.";"Quindicinale";"Annuale";"0";"0";"149";"0";"149";"0";"0";"0";"0";"0";"149";"Torino";""
"2014";" 001115 ";"GIAVENO";"VIALE REGINA ELENA";"Mercato";"lun. mar. mer. gio. ven. dom.";"Settimanale";"Annuale";"0";"0";"0";"15";"15";"0";"0";"0";"6";"6";"21";"Torino";""
"2014";" 001134 ";"LOCANA";"VIA ROMA";"Mercato";"mer.";"Settimanale";"Annuale";"0";"6";"9";"2";"17";"0";"6";"9";"0";"15";"32";"Torino";""
"2014";" 001161 ";"MONTANARO";"Piazza L. Massa";"Mercato";"sab.";"Settimanale";"Annuale";"0";"11";"19";"2";"32";"0";"0";"1";"0";"1";"33";"Torino";""
"2014";" 001161 ";"MONTANARO";"Via C. Battisti - Via Roma - Via Cavour - Via Caluso";"Mercato";"sab.";"Settimanale";"Annuale";"63";"0";"0";"4";"67";"0";"0";"0";"0";"0";"67";"Torino";""
"2014";" 001164 ";"NICHELINO";"PIAZZA CAMANDONA ANGOLO VIA DEI MARTIRI";"Posteggio isolato";"dom.";"Settimanale";"Annuale";"0";"0";"1";"0";"1";"0";"0";"0";"0";"0";"1";"Torino";""
"2014";" 001115 ";"GIAVENO";"PIAZZE CENTRALI";"Mercato";"dom.";"Quindicinale";"Stagionale";"0";"10";"201";"0";"211";"0";"0";"0";"0";"0";"211";"Torino";""
"2014";" 001125 ";"IVREA";"VIA CIRCONVALLAZIONE";"Mercato";"ven.";"Settimanale";"Annuale";"0";"2";"268";"0";"270";"0";"0";"5";"0";"5";"275";"Torino";""
"2014";" 001156 ";"MONCALIERI";"piazzale centro commerciale CARREFOUR";"Mercato";"mar.";"Settimanale";"Annuale";"10";"0";"0";"1";"11";"11";"0";"0";"2";"13";"24";"Torino";""
"2014";" 001162 ";"MONTEU DA PO";"PIAZZA BAVA";"Mercato";"lun.";"Settimanale";"Annuale";"0";"1";"0";"0";"1";"1";"3";"8";"2";"14";"15";"Torino";""
"2014";" 001171 ";"ORBASSANO";"Via Gramsci";"Posteggio isolato";"lun. mar. mer. gio. ven.";"Settimanale";"Annuale";"0";"0";"0";"0";"0";"1";"0";"0";"0";"1";"1";"Torino";""
"2014";" 001171 ";"ORBASSANO";"Via G. Deledda";"Posteggio isolato";"lun. mar. mer. gio. ven.";"Settimanale";"Annuale";"0";"0";"0";"0";"0";"1";"0";"0";"0";"1";"1";"Torino";""
"2014";" 001120 ";"GRUGLIASCO";"VIA LEON TRON";"Mercato";"mar.";"Settimanale";"Annuale";"6";"25";"43";"3";"77";"0";"1";"0";"2";"3";"80";"Torino";""
"2014";" 001147 ";"MATTIE";"VIA ROMA N. 4";"Mercato";"mer.";"Settimanale";"Annuale";"0";"0";"0";"0";"0";"3";"0";"0";"3";"6";"6";"Torino";""
"2014";" 001156 ";"MONCALIERI";"Piazza Marconi";"Mercato";"mar.";"Settimanale";"Annuale";"42";"0";"0";"1";"43";"11";"0";"0";"3";"14";"57";"Torino";""
"2014";" 001171 ";"ORBASSANO";"Strada Torino";"Posteggio isolato";"lun. mar. mer. gio. ven.";"Settimanale";"Annuale";"0";"0";"0";"0";"0";"1";"0";"0";"0";"1";"1";"Torino";""
"2014";" 001130 ";"LEINI'";"PIAZZA 1ï¾° MAGGIO";"Mercato";"sab.";"Settimanale";"Annuale";"0";"33";"30";"8";"71";"0";"3";"4";"0";"7";"78";"Torino";""
"2014";" 001155 ";"MONASTERO DI LANZO";"MONASTERO DI LANZO";"Mercato";"gio.";"Settimanale";"Annuale";"0";"3";"4";"1";"8";"0";"0";"0";"0";"0";"8";"Torino";""
"2014";" 001156 ";"MONCALIERI";"Piazza Beria";"Mercato";"sab.";"Settimanale";"Annuale";"2";"0";"0";"0";"2";"1";"0";"0";"0";"1";"3";"Torino";""
"2014";" 001171 ";"ORBASSANO";"Piazza De Amicis";"Posteggio isolato";"lun. mar. mer. gio. ven.";"Settimanale";"Annuale";"0";"0";"0";"0";"0";"1";"0";"0";"0";"1";"1";"Torino";""
"2014";" 001128 ";"LANZO TORINESE";"VIA DELLE VALLI 16";"Posteggio isolato";"lun. mar. mer. gio. ven. sab.";"Settimanale";"Annuale";"1";"0";"0";"0";"1";"0";"0";"0";"0";"0";"1";"Torino";""
"2014";" 001156 ";"MONCALIERI";"Piazza Brennero";"Mercato";"lun.";"Settimanale";"Annuale";"110";"0";"0";"3";"113";"1";"0";"0";"2";"3";"116";"Torino";""
"2014";" 001164 ";"NICHELINO";"VIA TORINO ANG. VIA GALIMBERTI";"Posteggio isolato";"dom.";"Settimanale";"Annuale";"0";"0";"1";"0";"1";"0";"0";"0";"0";"0";"1";"Torino";""
"2014";" 001164 ";"NICHELINO";"PIAZZA LIBERTA'";"Posteggio isolato";"lun. mar. mer. gio. ven. sab.";"Settimanale";"Annuale";"0";"0";"0";"0";"0";"0";"0";"1";"0";"1";"1";"Torino";""
"2014";" 001164 ";"NICHELINO";"VIA GOZZANO";"Mercato";"lun.";"Settimanale";"Annuale";"14";"8";"4";"2";"28";"14";"8";"4";"2";"28";"56";"Torino";""
"2014";" 001125 ";"IVREA";"VIA LAGO SIRIO";"Mercato";"ven.";"Settimanale";"Annuale";"0";"1";"13";"6";"20";"0";"0";"0";"2";"2";"22";"Torino";""
"2014";" 001125 ";"IVREA";"VIA MONTESTELLA";"Mercato";"ven.";"Settimanale";"Annuale";"0";"53";"6";"20";"79";"0";"14";"0";"12";"26";"105";"Torino";""
"2014";" 001130 ";"LEINI'";"PIAZZA 1ï¾° MAGGIO";"Mercato";"gio.";"Settimanale";"Annuale";"0";"30";"72";"4";"106";"0";"0";"2";"0";"2";"108";"Torino";""
"2014";" 001164 ";"NICHELINO";"PIAZZA LIBERTA' SS. TRINITA'";"Posteggio isolato";"dom.";"Settimanale";"Annuale";"0";"0";"1";"0";"1";"0";"0";"0";"0";"0";"1";"Torino";""
"2014";" 001164 ";"NICHELINO";"PIAZZA PERTINI";"Mercato";"mar.";"Settimanale";"Annuale";"0";"2";"0";"0";"2";"0";"0";"1";"0";"1";"3";"Torino";""
"2014";" 001171 ";"ORBASSANO";"Piazza della Pace";"Mercato";"mer.";"Settimanale";"Annuale";"230";"40";"0";"30";"300";"9";"9";"0";"12";"30";"330";"Torino";""
"2014";" 001118 ";"GROSCAVALLO";"Pialpetta-P.zza 8 Villaggi";"Mercato";"mer.";"Settimanale";"Stagionale";"7";"6";"5";"0";"18";"0";"0";"0";"0";"0";"18";"Torino";""
"2014";" 001146 ";"MATHI";"PIAZZA DON BURZIO";"Mercato";"gio.";"Settimanale";"Annuale";"0";"14";"18";"0";"32";"0";"4";"9";"0";"13";"45";"Torino";""
"2014";" 001156 ";"MONCALIERI";"Centro Storico";"Mercato";"ven.";"Settimanale";"Annuale";"89";"14";"0";"3";"106";"6";"1";"0";"5";"12";"118";"Torino";""
"2014";" 001161 ";"MONTANARO";"Piazza Donatori Sangue";"Mercato";"gio.";"Settimanale";"Annuale";"0";"1";"3";"5";"9";"0";"0";"0";"0";"0";"9";"Torino";""
"2014";" 001166 ";"NOLE";"VIA DEVESI (piazzale Ex Erber)";"Mercato";"mer.";"Settimanale";"Annuale";"0";"13";"20";"0";"33";"7";"0";"0";"2";"9";"42";"Torino";""
"2014";" 001171 ";"ORBASSANO";"Via Allende / Via Amendola";"Posteggio isolato";"lun. mar. mer. gio. ven.";"Settimanale";"Annuale";"0";"0";"0";"0";"0";"1";"0";"0";"0";"1";"1";"Torino";""
"2014";" 001124 ";"ISSIGLIO";"piazzale corso umberto";"Posteggio isolato";"sab.";"Settimanale";"Annuale";"1";"0";"0";"0";"1";"0";"0";"0";"0";"0";"1";"Torino";""
"2014";" 001128 ";"LANZO TORINESE";"VIA TORINO";"Posteggio isolato";"lun. mar. mer. gio. ven. sab.";"Settimanale";"Annuale";"0";"1";"0";"0";"1";"0";"0";"0";"0";"0";"1";"Torino";""
"2014";" 001136 ";"LOMBRIASCO";"VIA CESARE PONTE";"Mercato";"ven.";"Settimanale";"Annuale";"2";"2";"1";"0";"5";"6";"0";"0";"0";"6";"11";"Torino";""
"2014";" 001156 ";"MONCALIERI";"Piazza Panissera";"Mercato";"gio.";"Settimanale";"Annuale";"12";"0";"0";"1";"13";"16";"0";"0";"2";"18";"31";"Torino";""
"2014";" 001166 ";"NOLE";"PIAZZA V. EMANUELE";"Posteggio isolato";"sab.";"Settimanale";"Annuale";"0";"1";"0";"0";"1";"0";"0";"0";"0";"0";"1";"Torino";""
"2014";" 001171 ";"ORBASSANO";"Strada Volvera";"Posteggio isolato";"lun. mar. mer. gio. ven.";"Settimanale";"Annuale";"0";"0";"0";"0";"0";"1";"0";"0";"0";"1";"1";"Torino";""
"2014";" 001120 ";"GRUGLIASCO";"VIALE ECHIROLLES/VIA LEON TRON";"Mercato";"sab.";"Settimanale";"Annuale";"12";"41";"116";"8";"177";"0";"0";"0";"2";"2";"179";"Torino";""
"2014";" 001131 ";"LEMIE";"PIAZZA DON GIRARDI";"Mercato";"dom.";"Settimanale";"Stagionale";"0";"3";"3";"0";"6";"0";"0";"0";"0";"0";"6";"Torino";""
"2014";" 001148 ";"MAZZE'";"PIAZZA DELLA REPUBBLICA";"Mercato";"sab.";"Settimanale";"Annuale";"0";"5";"3";"0";"8";"0";"2";"2";"1";"5";"13";"Torino";""
"2014";" 001152 ";"MEZZENILE";"PIAZZA SAN ROCCO - VIA VILLA INFERIORE";"Mercato";"ven.";"Settimanale";"Annuale";"0";"1";"0";"0";"1";"0";"5";"7";"2";"14";"15";"Torino";""
"2014";" 001156 ";"MONCALIERI";"Piazza S. Maria";"Mercato";"mer.";"Settimanale";"Annuale";"0";"1";"0";"0";"1";"24";"0";"0";"1";"25";"26";"Torino";""
"2014";" 001164 ";"NICHELINO";"PIAZZA C. A. DALLA CHIESA";"Mercato";"sab.";"Settimanale";"Annuale";"0";"50";"105";"14";"169";"0";"1";"2";"1";"4";"173";"Torino";""
"2014";" 001125 ";"IVREA";"VIA MONTESTELLA";"Mercato";"mar.";"Settimanale";"Annuale";"0";"29";"3";"20";"52";"0";"24";"10";"12";"46";"98";"Torino";""
"2014";" 001127 ";"LA LOGGIA";"Piazza L. Einaudi";"Mercato";"sab.";"Settimanale";"Annuale";"27";"0";"0";"3";"30";"13";"0";"0";"1";"14";"44";"Torino";""
"2014";" 001140 ";"LUSERNETTA";"PIAZZA SANT' ANTONIO";"Mercato";"gio.";"Settimanale";"Annuale";"0";"3";"0";"0";"3";"0";"0";"0";"0";"0";"3";"Torino";""
"2014";" 001171 ";"ORBASSANO";"Strada Stupinigi";"Posteggio isolato";"lun. mar. mer. gio. ven. sab.";"Settimanale";"Annuale";"0";"0";"0";"0";"0";"1";"0";"0";"0";"1";"1";"Torino";""
"2014";" 001125 ";"IVREA";"CANTON MARIDON - SAN GRATO";"Mercato";"gio.";"Settimanale";"Annuale";"0";"4";"3";"1";"8";"0";"7";"11";"0";"18";"26";"Torino";""
"2014";" 001128 ";"LANZO TORINESE";"PIAZZA PERADOTTO";"Mercato";"sab.";"Settimanale";"Annuale";"0";"0";"0";"9";"9";"0";"0";"0";"0";"0";"9";"Torino";""
"2014";" 001164 ";"NICHELINO";"PIAZZA A. MORO";"Mercato";"mar.";"Settimanale";"Annuale";"0";"2";"2";"2";"6";"9";"0";"0";"0";"9";"15";"Torino";""
"2014";" 001164 ";"NICHELINO";"PIAZZA A. MORO";"Mercato";"gio.";"Settimanale";"Annuale";"14";"0";"0";"1";"15";"0";"0";"0";"0";"0";"15";"Torino";""
"2014";" 001171 ";"ORBASSANO";"Via Marconi";"Posteggio isolato";"lun. mar. mer. gio. ven.";"Settimanale";"Annuale";"0";"0";"0";"0";"0";"1";"0";"0";"0";"1";"1";"Torino";""
"2014";" 001174 ";"OSASIO";"piazza castello";"Mercato";"mar.";"Settimanale";"Annuale";"0";"2";"2";"0";"4";"0";"0";"0";"0";"0";"4";"Torino";""
"2014";" 001120 ";"GRUGLIASCO";"VIA BARACCA";"Mercato";"ven.";"Settimanale";"Annuale";"0";"5";"1";"0";"6";"0";"7";"10";"2";"19";"25";"Torino";""
"2014";" 001129 ";"LAURIANO";"PIAZZA RISORGIMENTO";"Mercato";"mer.";"Settimanale";"Annuale";"0";"5";"4";"0";"9";"0";"0";"0";"1";"1";"10";"Torino";""
"2014";" 001156 ";"MONCALIERI";"Piazza Vico";"Mercato";"sab.";"Settimanale";"Annuale";"5";"0";"0";"2";"7";"47";"0";"0";"1";"48";"55";"Torino";""
"2014";" 001160 ";"MONTALTO DORA";"Via Ivrea";"Mercato";"mer.";"Settimanale";"Annuale";"0";"5";"2";"0";"7";"0";"1";"4";"8";"13";"20";"Torino";""
"2014";" 001164 ";"NICHELINO";"PIAZZA S. QUIRICO";"Mercato";"mer.";"Settimanale";"Annuale";"1";"19";"21";"10";"51";"9";"0";"0";"1";"10";"61";"Torino";""
"2014";" 001168 ";"NONE";"P.CAVOUR/V.BECCARIA parte/VIA STAZIONE/V.S.ROCCO/P.RUBIANO/V.ROMA parte";"Mercato";"gio.";"Settimanale";"Annuale";"0";"24";"72";"10";"106";"0";"0";"0";"0";"0";"106";"Torino";""
"2014";" 001171 ";"ORBASSANO";"Piazza Silvio Pellico";"Mercato";"sab.";"Settimanale";"Annuale";"0";"2";"0";"0";"2";"0";"8";"20";"0";"28";"30";"Torino";""
"2014";" 001171 ";"ORBASSANO";"Piazza Rondini";"Posteggio isolato";"lun. mar. mer. gio. ven.";"Settimanale";"Annuale";"0";"0";"0";"0";"0";"1";"0";"0";"0";"1";"1";"Torino";""
"2014";" 001116 ";"GIVOLETTO";"P.ZZA DELLA CONCORDIA";"Mercato";"mar.";"Settimanale";"Annuale";"0";"2";"0";"0";"2";"0";"4";"0";"1";"5";"7";"Torino";""
"2014";" 001125 ";"IVREA";"CANTON MARIDON - SAN GRATO";"Mercato";"sab.";"Settimanale";"Annuale";"0";"11";"10";"1";"22";"0";"0";"4";"0";"4";"26";"Torino";""
"2014";" 001126 ";"LA CASSA";"Piazza Michele GALETTO";"Mercato";"gio.";"Settimanale";"Annuale";"0";"6";"3";"1";"10";"2";"0";"0";"0";"2";"12";"Torino";""
"2014";" 001128 ";"LANZO TORINESE";"VIA UMBERTO I - PIAZZA ROLLE";"Mercato";"mar.";"Settimanale";"Annuale";"0";"32";"96";"10";"138";"0";"0";"0";"0";"0";"138";"Torino";""
"2014";" 001135 ";"LOMBARDORE";"piazza Don Lanterno";"Mercato";"mer.";"Settimanale";"Annuale";"0";"3";"0";"0";"3";"0";"2";"1";"1";"4";"7";"Torino";""
"2014";" 001137 ";"LORANZE'";"Piazza della Liberta'";"Mercato";"gio.";"Settimanale";"Annuale";"0";"5";"4";"1";"10";"0";"0";"0";"0";"0";"10";"Torino";""
"2014";" 001139 ";"LUSERNA SAN GIOVANNI";"zona Airali";"Mercato";"ven.";"Settimanale";"Annuale";"0";"19";"46";"22";"87";"13";"0";"0";"6";"19";"106";"Torino";""
"2014";" 001141 ";"LUSIGLIE'";"PIAZZA MARTIRI";"Mercato";"mar.";"Settimanale";"Annuale";"0";"2";"1";"0";"3";"1";"0";"1";"0";"2";"5";"Torino";""
"2014";" 001164 ";"NICHELINO";"VIA CALATAFIMI ANG. VIA QUARTO";"Posteggio isolato";"lun. mar. mer. gio. ven.";"Settimanale";"Annuale";"0";"1";"0";"0";"1";"0";"0";"0";"0";"0";"1";"Torino";""
"2014";" 001164 ";"NICHELINO";"VIA XXV APRILE ANG. VIA STUPINIGI";"Posteggio isolato";"dom.";"Settimanale";"Annuale";"0";"0";"1";"0";"1";"0";"0";"0";"0";"0";"1";"Torino";""
"2014";" 001164 ";"NICHELINO";"VIALE RIMEMBRANZA";"Posteggio isolato";"lun. mar. mer. gio. ven. sab. dom.";"Settimanale";"Stagionale";"1";"0";"0";"0";"1";"0";"0";"0";"0";"0";"1";"Torino";""
"2014";" 001170 ";"OGLIANICO";"PIAZZA RICETTI";"Mercato";"ven.";"Settimanale";"Annuale";"0";"4";"5";"0";"9";"0";"0";"0";"0";"0";"9";"Torino";""
"2014";" 001132 ";"LESSOLO";"PIAZZA DEL MERCATO";"Mercato";"mer.";"Settimanale";"Annuale";"0";"6";"8";"0";"14";"0";"0";"0";"4";"4";"18";"Torino";""
"2014";" 001161 ";"MONTANARO";"Piazza Luigi Massa";"Mercato";"mar.";"Settimanale";"Annuale";"0";"7";"6";"2";"15";"0";"0";"0";"0";"0";"15";"Torino";""
"2014";" 001176 ";"OZEGNA";"PIAZZA UMBERTO I";"Mercato";"mar.";"Settimanale";"Annuale";"0";"3";"2";"0";"5";"0";"0";"0";"0";"0";"5";"Torino";""
"2014";" 001192 ";"PINO TORINESE";"PIAZZA MUNICIPIO";"Mercato";"gio.";"Settimanale";"Annuale";"0";"9";"4";"4";"17";"0";"2";"4";"3";"9";"26";"Torino";""
"2014";" 001194 ";"PIOSSASCO";"VIA KENNEDY - PIAZZA PERTINI";"Mercato";"gio.";"Settimanale";"Annuale";"0";"21";"57";"9";"87";"3";"0";"0";"0";"3";"90";"Torino";""
"2014";" 001199 ";"PONT-CANAVESE";"Piazza Craveri e Via Caviglione";"Mercato";"lun.";"Settimanale";"Annuale";"0";"13";"24";"2";"39";"9";"0";"0";"0";"9";"48";"Torino";""
"2014";" 001223 ";"ROMANO CANAVESE";"VIA DEI FIORI";"Posteggio isolato";"sab.";"Settimanale";"Annuale";"0";"0";"0";"0";"0";"0";"1";"0";"0";"1";"1";"Torino";""
"2014";" 001177 ";"PALAZZO CANAVESE";"PIAZZALE CIMITERO";"Posteggio isolato";"mer.";"Settimanale";"Annuale";"0";"0";"1";"0";"1";"0";"0";"0";"0";"0";"1";"Torino";""
"2014";" 001194 ";"PIOSSASCO";"VIA DANTE ALIGHIERI";"Mercato";"gio.";"Settimanale";"Annuale";"0";"19";"31";"5";"55";"0";"1";"4";"0";"5";"60";"Torino";""
"2014";" 001195 ";"PISCINA";"PIAZZA EUGENIA CORTI";"Mercato";"lun.";"Settimanale";"Annuale";"0";"8";"16";"5";"29";"0";"0";"0";"0";"0";"29";"Torino";""
"2014";" 001219 ";"RIVOLI";"PIAZZA CAVALLERO";"Mercato";"mar.";"Settimanale";"Annuale";"6";"10";"12";"3";"31";"0";"0";"0";"0";"0";"31";"Torino";""
"2014";" 001231 ";"SALASSA";"PIAZZA TAMIETTI";"Mercato";"mer.";"Settimanale";"Annuale";"0";"3";"0";"0";"3";"0";"0";"0";"0";"0";"3";"Torino";""
"2014";" 001183 ";"PECETTO TORINESE";"STRADA REVIGLIASCO/STRADA VALLE SAUGLIO";"Mercato";"ven.";"Settimanale";"Annuale";"1";"5";"3";"1";"10";"0";"0";"0";"0";"0";"10";"Torino";""
"2014";" 001191 ";"PINEROLO";"PIAZZA ROMA";"Mercato";"mer.";"Settimanale";"Annuale";"0";"0";"0";"37";"37";"0";"0";"0";"79";"79";"116";"Torino";""
"2014";" 001191 ";"PINEROLO";"PIAZZA ROMA";"Mercato";"sab.";"Settimanale";"Annuale";"0";"0";"0";"59";"59";"0";"0";"0";"61";"61";"120";"Torino";""
"2014";" 001198 ";"POMARETTO";"Piazza Caffer";"Mercato";"gio.";"Settimanale";"Annuale";"0";"0";"0";"0";"0";"8";"0";"0";"1";"9";"9";"Torino";""
"2014";" 001214 ";"RIVALTA DI TORINO";"PIAZZA GERBIDI";"Mercato";"mar.";"Settimanale";"Annuale";"0";"17";"41";"9";"67";"0";"0";"0";"0";"0";"67";"Torino";""
"2014";" 001219 ";"RIVOLI";"P.ZA SAN ROCCO";"Mercato";"sab.";"Settimanale";"Annuale";"0";"3";"0";"1";"4";"0";"5";"4";"1";"10";"14";"Torino";""
"2014";" 001177 ";"PALAZZO CANAVESE";"PIAZZALE CIMITERO";"Posteggio isolato";"lun. mar. mer. gio. ven. sab.";"Settimanale";"Annuale";"0";"1";"0";"0";"1";"0";"0";"0";"0";"0";"1";"Torino";""
"2014";" 001194 ";"PIOSSASCO";"largo IIIï¾° reg.Alpini";"Mercato";"mar. ven.";"Settimanale";"Annuale";"0";"2";"0";"0";"2";"0";"0";"0";"0";"0";"2";"Torino";""
"2014";" 001219 ";"RIVOLI";"LOCALITA' TETTI NEIROTTI";"Mercato";"lun.";"Settimanale";"Annuale";"0";"1";"0";"0";"1";"5";"0";"0";"0";"5";"6";"Torino";""
"2014";" 001219 ";"RIVOLI";"PIAZZA ALDO MORO E VIE LIMITROFE";"Mercato";"ven.";"Settimanale";"Annuale";"24";"36";"162";"11";"233";"1";"0";"0";"2";"3";"236";"Torino";""
"2014";" 001228 ";"ROSTA";"PIAZZA CADUTI DI NASSIRIYA";"Mercato";"mer.";"Settimanale";"Annuale";"0";"7";"4";"2";"13";"0";"0";"0";"0";"0";"13";"Torino";""
"2014";" 001230 ";"RUEGLIO";"PIAZZA MUNICIPIO";"Mercato";"sab.";"Settimanale";"Annuale";"0";"6";"2";"1";"9";"0";"0";"0";"0";"0";"9";"Torino";""
"2014";" 001179 ";"PARELLA";"PIAZZA GIACOMO BARATTIA";"Mercato";"ven.";"Settimanale";"Annuale";"0";"2";"0";"0";"2";"0";"0";"0";"0";"0";"2";"Torino";""
"2014";" 001182 ";"PECCO";"PIAZZA SAN MARTINIANO";"Mercato";"sab.";"Settimanale";"Annuale";"0";"4";"2";"0";"6";"0";"0";"0";"0";"0";"6";"Torino";""
"2014";" 001191 ";"PINEROLO";"PIAZZA VITTORIO VENETO";"Mercato";"mer.";"Settimanale";"Annuale";"29";"67";"140";"23";"259";"1";"6";"6";"24";"37";"296";"Torino";""
"2014";" 001191 ";"PINEROLO";"VIA LEQUIO";"Mercato";"sab.";"Settimanale";"Annuale";"0";"0";"4";"0";"4";"0";"0";"6";"0";"6";"10";"Torino";""
"2014";" 001191 ";"PINEROLO";"PIAZZA VITTORIO VENETO";"Mercato";"ven.";"Settimanale";"Annuale";"0";"3";"0";"0";"3";"0";"0";"0";"0";"0";"3";"Torino";""
"2014";" 001189 ";"PIANEZZA";"VIA DON BOSCO - VIA ROSSELLI";"Mercato";"gio.";"Settimanale";"Annuale";"0";"19";"39";"3";"61";"0";"0";"0";"0";"0";"61";"Torino";""
"2014";" 001189 ";"PIANEZZA";"Via Musine'";"Mercato";"sab.";"Settimanale";"Annuale";"0";"9";"5";"3";"17";"0";"3";"12";"2";"17";"34";"Torino";""
"2014";" 001214 ";"RIVALTA DI TORINO";"VIA MATTEI";"Mercato";"mar.";"Settimanale";"Annuale";"0";"12";"18";"0";"30";"0";"8";"9";"2";"19";"49";"Torino";""
"2014";" 001221 ";"ROCCA CANAVESE";"Piazza Del Mercato";"Mercato";"mer.";"Settimanale";"Annuale";"0";"10";"14";"3";"27";"0";"2";"2";"1";"5";"32";"Torino";""
"2014";" 001187 ";"PERTUSIO";"PIAZZA S.FIRMINIO";"Mercato";"ven.";"Settimanale";"Annuale";"0";"3";"0";"0";"3";"0";"0";"0";"0";"0";"3";"Torino";""
"2014";" 001190 ";"PINASCA";"Piazza Internati Militari Italiani";"Mercato";"sab.";"Settimanale";"Annuale";"0";"8";"10";"3";"21";"0";"2";"8";"0";"10";"31";"Torino";""
"2014";" 001191 ";"PINEROLO";"VIA CHIAPPERO";"Mercato";"lun. mar. mer. gio. ven. sab.";"Settimanale";"Annuale";"0";"0";"2";"0";"2";"0";"0";"0";"0";"0";"2";"Torino";""
"2014";" 001202 ";"PRALI";"FRAZIONE GHIGO";"Mercato";"ven.";"Settimanale";"Annuale";"0";"0";"0";"0";"0";"2";"2";"10";"3";"17";"17";"Torino";""
"2014";" 001216 ";"RIVARA";"P.zza Martiri della Liberazione, P.zza Statuto, P.zza Barbacana e Via B. Grassa";"Mercato";"mer.";"Settimanale";"Annuale";"0";"11";"20";"1";"32";"0";"5";"10";"3";"18";"50";"Torino";""
"2014";" 001217 ";"RIVAROLO CANAVESE";"Piazza Massoglia";"Mercato";"mer.";"Settimanale";"Annuale";"0";"21";"28";"16";"65";"0";"0";"1";"3";"4";"69";"Torino";""
"2014";" 001194 ";"PIOSSASCO";"largo IIIï¾° reg.Alpini";"Posteggio isolato";"mar.";"Settimanale";"Annuale";"0";"1";"0";"0";"1";"0";"0";"0";"0";"0";"1";"Torino";""
"2014";" 001191 ";"PINEROLO";"PIAZZA VITTORIO VENETO";"Mercato";"sab.";"Settimanale";"Annuale";"26";"70";"211";"23";"330";"5";"3";"15";"16";"39";"369";"Torino";""
"2014";" 001191 ";"PINEROLO";"VIA DEL DUOMO";"Mercato";"lun. mar. mer. gio. ven. sab.";"Settimanale";"Annuale";"0";"2";"0";"0";"2";"0";"1";"0";"0";"1";"3";"Torino";""
"2014";" 001193 ";"PIOBESI TORINESE";"PIAZZA I MAGGIO";"Mercato";"mar.";"Settimanale";"Annuale";"0";"8";"10";"2";"20";"0";"6";"9";"2";"17";"37";"Torino";""
"2014";" 001224 ";"RONCO CANAVESE";"PIAZZA MISTRAL";"Mercato";"sab.";"Settimanale";"Annuale";"0";"5";"6";"0";"11";"0";"0";"0";"0";"0";"11";"Torino";""
"2014";" 001225 ";"RONDISSONE";"Piazza Gabriele D'ANNUNZIO";"Mercato";"sab.";"Settimanale";"Annuale";"0";"5";"3";"1";"9";"0";"0";"0";"1";"1";"10";"Torino";""
"2014";" 001184 ";"PEROSA ARGENTINA";"Via XXVIIIï¾° Aprile";"Mercato";"mer.";"Settimanale";"Annuale";"0";"0";"0";"6";"6";"0";"0";"0";"4";"4";"10";"Torino";""
"2014";" 001188 ";"PESSINETTO";"VIA ROMA - STRADA PROVINCIALE";"Mercato";"mer.";"Settimanale";"Annuale";"0";"5";"4";"0";"9";"0";"0";"1";"1";"2";"11";"Torino";""
"2014";" 001189 ";"PIANEZZA";"VIA TORINO";"Posteggio isolato";"mar. mer. gio. ven. sab. dom.";"Settimanale";"Annuale";"0";"0";"1";"0";"1";"0";"0";"0";"0";"0";"1";"Torino";""
"2014";" 001208 ";"QUAGLIUZZO";"PIAZZA XX SETTEMBRE";"Mercato";"mar.";"Settimanale";"Annuale";"0";"3";"0";"0";"3";"0";"0";"0";"0";"0";"3";"Torino";""
"2014";" 001184 ";"PEROSA ARGENTINA";"Piazza III Alpini/Via XXVIII Aprile/Viale Duca d'Aosta";"Mercato";"dom.";"Settimanale";"Annuale";"0";"15";"35";"8";"58";"0";"2";"25";"2";"29";"87";"Torino";""
"2014";" 001199 ";"PONT-CANAVESE";"Piazza Craveri";"Posteggio isolato";"ven.";"Settimanale";"Annuale";"0";"1";"0";"0";"1";"0";"0";"0";"0";"0";"1";"Torino";""
"2014";" 001219 ";"RIVOLI";"VIA ROMBO' - PIAZZALE PORTICI";"Mercato";"mer.";"Settimanale";"Annuale";"4";"18";"21";"6";"49";"0";"0";"0";"1";"1";"50";"Torino";""
"2014";" 001219 ";"RIVOLI";"GIARDINI FALCONE";"Mercato";"mar.";"Settimanale";"Annuale";"0";"2";"1";"2";"5";"0";"7";"10";"2";"19";"24";"Torino";""
"2014";" 001178 ";"PANCALIERI";"PIAZZA SAN NICOLAO";"Mercato";"lun.";"Settimanale";"Annuale";"0";"7";"14";"1";"22";"0";"7";"14";"1";"22";"44";"Torino";""
"2014";" 001189 ";"PIANEZZA";"via susa, 40";"Posteggio isolato";"lun. mar. mer. gio. ven. sab.";"Settimanale";"Stagionale";"0";"1";"0";"0";"1";"0";"0";"0";"0";"0";"1";"Torino";""
"2014";" 001197 ";"POIRINO";"Piazza Morioni";"Mercato";"lun. mar. mer. gio. ven. sab.";"Settimanale";"Stagionale";"0";"0";"0";"5";"5";"0";"0";"0";"20";"20";"25";"Torino";""
"2014";" 001201 ";"PRAGELATO";"P.zza Lantelme";"Mercato";"dom.";"Settimanale";"Annuale";"0";"8";"16";"7";"31";"0";"1";"1";"1";"3";"34";"Torino";""
"2014";" 001214 ";"RIVALTA DI TORINO";"VIA TORINO";"Mercato";"sab.";"Settimanale";"Annuale";"0";"9";"2";"5";"16";"0";"0";"8";"1";"9";"25";"Torino";""
"2014";" 001215 ";"RIVA PRESSO CHIERI";"Piazza Carlo Emanuele I";"Mercato";"mer.";"Settimanale";"Annuale";"0";"8";"9";"0";"17";"3";"0";"0";"2";"5";"22";"Torino";""
"2014";" 001219 ";"RIVOLI";"PIAZZA DELLA REPUBBLICA";"Mercato";"gio.";"Settimanale";"Annuale";"10";"16";"28";"4";"58";"0";"0";"0";"0";"0";"58";"Torino";""
"2014";" 001219 ";"RIVOLI";"VIALE DI NANNI";"Mercato";"gio.";"Settimanale";"Annuale";"2";"6";"9";"2";"19";"18";"0";"0";"2";"20";"39";"Torino";""
"2014";" 001220 ";"ROBASSOMERO";"PIAZZA CLN";"Mercato";"gio.";"Settimanale";"Annuale";"0";"7";"5";"0";"12";"0";"0";"2";"1";"3";"15";"Torino";""
"2014";" 001227 ";"ROURE";"piazza comunale in fraz. Balma - localita' ""Casse'""";"Mercato";"gio.";"Settimanale";"Stagionale";"3";"0";"1";"0";"4";"0";"0";"0";"0";"0";"4";"Torino";""
"2014";" 001236 ";"SAN BENIGNO CANAVESE";"PIAZZA ITALIA";"Mercato";"ven.";"Settimanale";"Annuale";"0";"13";"23";"3";"39";"9";"0";"0";"0";"9";"48";"Torino";""
"2014";" 001181 ";"PAVONE CANAVESE";"PIAZZA FALCONE";"Mercato";"lun.";"Settimanale";"Annuale";"0";"5";"8";"0";"13";"3";"1";"5";"2";"11";"24";"Torino";""
"2014";" 001184 ";"PEROSA ARGENTINA";"Piazza III Alpini";"Mercato";"gio.";"Settimanale";"Annuale";"0";"1";"0";"0";"1";"0";"1";"0";"0";"1";"2";"Torino";""
"2014";" 001189 ";"PIANEZZA";"VIA CASSAGNA ANG. L.GO II GIUGNO";"Posteggio isolato";"lun. mar. mer. gio. ven. sab. dom.";"Settimanale";"Annuale";"0";"1";"0";"0";"1";"0";"0";"0";"0";"0";"1";"Torino";""
"2014";" 001191 ";"PINEROLO";"VIA SAN PIETRO VAL LEMINA";"Posteggio isolato";"lun. mar. mer. gio. ven. sab. dom.";"Settimanale";"Annuale";"0";"0";"1";"0";"1";"0";"0";"0";"0";"0";"1";"Torino";""
"2014";" 001191 ";"PINEROLO";"VIA SALUZZO";"Posteggio isolato";"lun. mar. mer. gio. ven. sab.";"Settimanale";"Annuale";"0";"1";"0";"0";"1";"0";"0";"0";"0";"0";"1";"Torino";""
"2014";" 001217 ";"RIVAROLO CANAVESE";"Piazza Massoglia - Via Ivrea - Corso Torino";"Mercato";"sab.";"Settimanale";"Annuale";"0";"46";"156";"19";"221";"0";"0";"4";"1";"5";"226";"Torino";""
"2014";" 001219 ";"RIVOLI";"PIAZZA CERVI E VIE LIMITROFE";"Mercato";"sab.";"Settimanale";"Annuale";"8";"25";"44";"4";"81";"9";"0";"0";"1";"10";"91";"Torino";""
"2014";" 001235 ";"SAMONE";"PIAZZA BERLINGUER";"Mercato";"ven.";"Settimanale";"Annuale";"0";"1";"2";"0";"3";"0";"0";"0";"0";"0";"3";"Torino";""
"2014";" 001175 ";"OULX";"PIAZZA GARAMBOIS";"Mercato";"mer.";"Settimanale";"Annuale";"0";"10";"27";"10";"47";"9";"0";"0";"0";"9";"56";"Torino";""
"2014";" 001189 ";"PIANEZZA";"VIA SUSA 32";"Posteggio isolato";"lun. mar. mer. gio. ven. sab.";"Settimanale";"Stagionale";"0";"1";"0";"0";"1";"0";"0";"0";"0";"0";"1";"Torino";""
"2014";" 001211 ";"REANO";"PIAZZALE DONATORI DI SANGUE - PIAZZETTA DEL MERCATO";"Mercato";"mar.";"Settimanale";"Annuale";"0";"6";"5";"1";"12";"0";"0";"0";"0";"0";"12";"Torino";""
"2014";" 001218 ";"RIVAROSSA";"VIA MARTIRI LIBERTA'";"Mercato";"lun.";"Settimanale";"Annuale";"0";"0";"0";"0";"0";"0";"4";"2";"0";"6";"6";"Torino";""
"2014";" 001191 ";"PINEROLO";"PIAZZA GARIBALDI";"Posteggio isolato";"lun. mar. mer. gio. ven. sab. dom.";"Settimanale";"Stagionale";"0";"0";"0";"0";"0";"0";"1";"0";"0";"1";"1";"Torino";""
"2014";" 001197 ";"POIRINO";"Piazza Italia";"Posteggio isolato";"mer.";"Settimanale";"Annuale";"0";"1";"0";"0";"1";"0";"0";"0";"0";"0";"1";"Torino";""
"2014";" 001197 ";"POIRINO";"p.zza italia";"Mercato";"sab.";"Settimanale";"Annuale";"0";"17";"40";"15";"72";"0";"1";"2";"1";"4";"76";"Torino";""
"2014";" 001260 ";"SCALENGHE";"SCALENGHE PIEVE - VIA SAVIGLIANI";"Posteggio isolato";"lun.";"Settimanale";"Annuale";"0";"0";"0";"0";"0";"1";"0";"0";"0";"1";"1";"Torino";""
"2014";" 001265 ";"SETTIMO TORINESE";"VIA LEVI";"Mercato";"ven.";"Settimanale";"Annuale";"0";"5";"1";"0";"6";"9";"16";"22";"1";"48";"54";"Torino";""
"2014";" 001275 ";"TORRE PELLICE";"Corso Gramsci (mercato coperto)";"Mercato";"mer.";"Settimanale";"Annuale";"0";"0";"0";"24";"24";"0";"0";"0";"2";"2";"26";"Torino";""
"2014";" 001292 ";"VENARIA REALE";"ADIACENZE JUVENTUS STADIUM";"Posteggio isolato";"dom.";"Settimanale";"Annuale";"0";"0";"1";"0";"1";"0";"0";"0";"0";"0";"1";"Torino";""
"2014";" 001256 ";"SANT'ANTONINO DI SUSA";"PIAZZA DELLA PACE";"Mercato";"sab.";"Settimanale";"Annuale";"0";"17";"26";"6";"49";"5";"3";"7";"0";"15";"64";"Torino";""
"2014";" 001259 ";"SAUZE D'OULX";"Piazzale Genevris";"Mercato";"ven.";"Settimanale";"Annuale";"27";"0";"0";"10";"37";"4";"0";"0";"0";"4";"41";"Torino";""
"2014";" 001272 ";"TORINO";"PIAZZA BARCELLONA";"Mercato";"lun. mar. mer. gio. ven. sab.";"Settimanale";"Annuale";"0";"28";"17";"3";"48";"0";"43";"52";"3";"98";"146";"Torino";""
"2014";" 001272 ";"TORINO";"CORSO TARANTO";"Mercato";"lun. mar. mer. gio. ven. sab.";"Settimanale";"Annuale";"0";"26";"13";"4";"43";"0";"17";"19";"5";"41";"84";"Torino";""
"2014";" 001272 ";"TORINO";"VIA DE MAISTRE";"Mercato";"lun. mar. mer. gio. ven. sab.";"Settimanale";"Annuale";"0";"1";"0";"0";"1";"0";"1";"0";"0";"1";"2";"Torino";""
"2014";" 001272 ";"TORINO";"CORSO REGIO PARCO";"Mercato";"lun. mar. mer. gio. ven. sab.";"Settimanale";"Annuale";"0";"0";"1";"0";"1";"0";"29";"18";"3";"50";"51";"Torino";""
"2014";" 001273 ";"TORRAZZA PIEMONTE";"PIAZZA DEL MUNICIPIO";"Mercato";"gio.";"Settimanale";"Annuale";"0";"4";"7";"1";"12";"0";"0";"0";"0";"0";"12";"Torino";""
"2014";" 001290 ";"VAUDA CANAVESE";"Piazza di Via Aldo Moro";"Mercato";"gio.";"Settimanale";"Annuale";"0";"3";"2";"0";"5";"0";"1";"5";"4";"10";"15";"Torino";""
"2014";" 001292 ";"VENARIA REALE";"VIALE BURIDANI";"Mercato";"dom.";"Quindicinale";"Annuale";"0";"0";"2";"0";"2";"0";"0";"48";"0";"48";"50";"Torino";""
"2014";" 001292 ";"VENARIA REALE";"PIAZZA NENNI";"Posteggio isolato";"sab.";"Settimanale";"Annuale";"0";"0";"0";"1";"1";"0";"0";"0";"0";"0";"1";"Torino";""
"2014";" 001292 ";"VENARIA REALE";"ADIACENZE JUVENTUS STADIUM";"Posteggio isolato";"dom.";"Settimanale";"Annuale";"0";"1";"0";"0";"1";"0";"0";"0";"0";"0";"1";"Torino";""
"2014";" 001245 ";"SAN GIORIO DI SUSA";"PIAZZA VELINO";"Mercato";"mer.";"Settimanale";"Annuale";"0";"2";"0";"1";"3";"0";"1";"2";"0";"3";"6";"Torino";""
"2014";" 001248 ";"SAN MAURIZIO CANAVESE";"PIAZZA MARCONI";"Mercato";"mer.";"Settimanale";"Annuale";"0";"20";"46";"7";"73";"0";"0";"1";"0";"1";"74";"Torino";""
"2014";" 001260 ";"SCALENGHE";"PIAZZA VIOTTO GIOVANNI BATTISTA";"Mercato";"ven.";"Settimanale";"Annuale";"0";"0";"0";"0";"0";"0";"6";"8";"2";"16";"16";"Torino";""
"2014";" 001272 ";"TORINO";"CORSO BOLZANO";"Mercato";"lun. mar. mer. gio. ven. sab.";"Settimanale";"Annuale";"0";"0";"1";"0";"1";"0";"6";"0";"0";"6";"7";"Torino";""
"2014";" 001272 ";"TORINO";"CORSO SPEZIA";"Mercato";"lun. mar. mer. gio. ven. sab.";"Settimanale";"Annuale";"0";"35";"52";"6";"93";"0";"8";"13";"0";"21";"114";"Torino";""
"2014";" 001292 ";"VENARIA REALE";"PIAZZA DE GASPERI";"Mercato";"mer.";"Settimanale";"Annuale";"0";"31";"55";"4";"90";"0";"5";"1";"0";"6";"96";"Torino";""
"2014";" 001262 ";"SCIOLZE";"SCIOLZE NUOVO POLO EDUCATIVO STRADA AMRENTINO";"Mercato";"mer.";"Settimanale";"Annuale";"0";"1";"3";"3";"7";"0";"2";"0";"6";"8";"15";"Torino";""
"2014";" 001263 ";"SESTRIERE";"SESTRIERE piazzale del Mercato";"Mercato";"mar.";"Settimanale";"Annuale";"0";"4";"13";"6";"23";"0";"5";"6";"3";"14";"37";"Torino";""
"2014";" 001272 ";"TORINO";"CORSO SVIZZERA";"Mercato";"lun. mar. mer. gio. ven. sab.";"Settimanale";"Annuale";"0";"61";"76";"2";"139";"0";"5";"15";"1";"21";"160";"Torino";""
"2014";" 001272 ";"TORINO";"CORSO VALDOCCO - CORSO PALESTRO";"Mercato";"lun. mar. mer. gio. ven. sab.";"Settimanale";"Annuale";"0";"10";"87";"2";"99";"0";"2";"12";"2";"16";"115";"Torino";""
"2014";" 001272 ";"TORINO";"VIA DI NANNI";"Mercato";"lun. mar. mer. gio. ven. sab.";"Settimanale";"Annuale";"0";"69";"59";"11";"139";"0";"67";"85";"14";"166";"305";"Torino";""
"2014";" 001272 ";"TORINO";"VIA NITTI";"Mercato";"mer. ven.";"Quindicinale";"Annuale";"0";"28";"39";"4";"71";"0";"14";"34";"4";"52";"123";"Torino";""
"2014";" 001292 ";"VENARIA REALE";"ADIACENZE PARCO REGIONALE ""LA MANDRIA"" TRE CANCELLI";"Posteggio isolato";"sab. dom.";"Settimanale";"Stagionale";"0";"1";"0";"0";"1";"0";"0";"0";"0";"0";"1";"Torino";""
"2014";" 001292 ";"VENARIA REALE";"ADIACENZE JUVENTUS STADIUM";"Posteggio isolato";"dom.";"Settimanale";"Annuale";"0";"0";"1";"0";"1";"0";"0";"0";"0";"0";"1";"Torino";""
"2014";" 001272 ";"TORINO";"CORSO BRUNELLESCHI";"Mercato";"lun. mar. mer. gio. ven. sab.";"Settimanale";"Annuale";"0";"66";"77";"10";"153";"0";"0";"7";"0";"7";"160";"Torino";""
"2014";" 001272 ";"TORINO";"PIAZZA MADAMA CRISTINA";"Mercato";"lun. mar. mer. gio. ven. sab.";"Settimanale";"Annuale";"0";"53";"58";"5";"116";"0";"16";"13";"4";"33";"149";"Torino";""
"2014";" 001272 ";"TORINO";"PIAZZA NIZZA";"Mercato";"lun. mar. mer. gio. ven. sab.";"Settimanale";"Annuale";"0";"20";"15";"1";"36";"0";"4";"14";"1";"19";"55";"Torino";""
"2014";" 001272 ";"TORINO";"VIA CENA";"Mercato";"mer.";"Settimanale";"Annuale";"0";"2";"0";"0";"2";"0";"1";"0";"0";"1";"3";"Torino";""
"2014";" 001276 ";"TRANA";"VIA XX SETTEMBRE";"Mercato";"lun.";"Settimanale";"Annuale";"0";"2";"0";"0";"2";"0";"2";"8";"0";"10";"12";"Torino";""
"2014";" 001292 ";"VENARIA REALE";"VIALE BURIDANI";"Mercato";"sab.";"Settimanale";"Annuale";"0";"45";"86";"11";"142";"0";"3";"4";"2";"9";"151";"Torino";""
"2014";" 001292 ";"VENARIA REALE";"ADIACENZE JUVENTUS STADIUM";"Posteggio isolato";"dom.";"Settimanale";"Annuale";"0";"0";"1";"0";"1";"0";"0";"0";"0";"0";"1";"Torino";""
"2014";" 001292 ";"VENARIA REALE";"PIAZZA NENNI";"Posteggio isolato";"ven.";"Settimanale";"Annuale";"0";"1";"0";"0";"1";"0";"0";"0";"0";"0";"1";"Torino";""
"2014";" 001292 ";"VENARIA REALE";"PIAZZA NENNI";"Posteggio isolato";"sab.";"Settimanale";"Annuale";"0";"0";"0";"1";"1";"0";"0";"0";"0";"0";"1";"Torino";""
"2014";" 001292 ";"VENARIA REALE";"ADIACENZE JUVENTUS STADIUM";"Posteggio isolato";"dom.";"Settimanale";"Annuale";"0";"1";"0";"0";"1";"0";"0";"0";"0";"0";"1";"Torino";""
"2014";" 001249 ";"SAN MAURO TORINESE";"PIAZZA EUROPA";"Mercato";"ven.";"Settimanale";"Annuale";"0";"27";"50";"8";"85";"0";"1";"1";"0";"2";"87";"Torino";""
"2014";" 001266 ";"SETTIMO VITTONE";"PIAZZA STATUTO - VIA G. MARCONI - PIAZZA VITTORIO EMANUELE II";"Mercato";"lun.";"Settimanale";"Annuale";"0";"3";"4";"0";"7";"0";"3";"5";"2";"10";"17";"Torino";""
"2014";" 001268 ";"STRAMBINELLO";"STRAMBINELLO - PIAZZA IV REGGIMENTO ALPINI";"Mercato";"dom.";"Settimanale";"Annuale";"0";"2";"2";"1";"5";"0";"2";"0";"0";"2";"7";"Torino";""
"2014";" 001272 ";"TORINO";"PIAZZA SAN SECONDO";"Mercato";"lun. mar. mer. gio. ven. sab.";"Settimanale";"Annuale";"0";"11";"9";"2";"22";"0";"27";"36";"0";"63";"85";"Torino";""
"2014";" 001272 ";"TORINO";"VIA BALTIMORA";"Mercato";"lun. mar. mer. gio. ven. sab.";"Settimanale";"Annuale";"0";"13";"9";"6";"28";"0";"13";"38";"0";"51";"79";"Torino";""
"2014";" 001292 ";"VENARIA REALE";"ADIACENZE JUVENTUS STADIUM";"Posteggio isolato";"dom.";"Settimanale";"Annuale";"0";"0";"1";"0";"1";"0";"0";"0";"0";"0";"1";"Torino";""
"2014";" 001292 ";"VENARIA REALE";"ADIACENZE JUVENTUS STADIUM";"Posteggio isolato";"dom.";"Settimanale";"Annuale";"0";"1";"0";"0";"1";"0";"0";"0";"0";"0";"1";"Torino";""
"2014";" 001249 ";"SAN MAURO TORINESE";"PIAZZA VITTIME DI NASSIRYA";"Mercato";"mer.";"Settimanale";"Annuale";"0";"2";"0";"0";"2";"0";"6";"10";"2";"18";"20";"Torino";""
"2014";" 001259 ";"SAUZE D'OULX";"FRAZIONE JOUVEVCEAUX";"Posteggio isolato";"mar. gio. sab.";"Settimanale";"Stagionale";"0";"0";"0";"1";"1";"0";"0";"0";"0";"0";"1";"Torino";""
"2014";" 001264 ";"SETTIMO ROTTARO";"PIAZZA DELLA CHIESA";"Mercato";"mer.";"Settimanale";"Annuale";"0";"0";"1";"0";"1";"0";"1";"2";"0";"3";"4";"Torino";""
"2014";" 001271 ";"TAVAGNASCO";"PIAZZA 1ï¾° MAGGIO";"Mercato";"gio.";"Settimanale";"Annuale";"0";"1";"1";"1";"3";"0";"0";"0";"0";"0";"3";"Torino";""
"2014";" 001272 ";"TORINO";"CORSO RACCONIGI";"Mercato";"lun. mar. mer. gio. ven. sab.";"Settimanale";"Annuale";"0";"120";"203";"11";"334";"0";"19";"21";"0";"40";"374";"Torino";""
"2014";" 001272 ";"TORINO";"CORSO TOSCANA - CORSO CINCINNATO";"Mercato";"lun. mar. mer. gio. ven. sab.";"Settimanale";"Annuale";"0";"43";"59";"8";"110";"0";"0";"9";"2";"11";"121";"Torino";""
"2014";" 001272 ";"TORINO";"REG. MIRAFIORI NORD";"Mercato";"lun. mar. mer. gio. ven. sab.";"Settimanale";"Annuale";"0";"42";"44";"9";"95";"0";"0";"9";"0";"9";"104";"Torino";""
"2014";" 001272 ";"TORINO";"PIAZZA BENGASI";"Mercato";"lun. mar. mer. gio. ven. sab.";"Settimanale";"Annuale";"0";"74";"86";"8";"168";"0";"14";"4";"0";"18";"186";"Torino";""
"2014";" 001272 ";"TORINO";"PIAZZA CARLINA";"Mercato";"lun. mar. mer. gio. ven. sab.";"Settimanale";"Annuale";"0";"4";"0";"2";"6";"0";"3";"0";"2";"5";"11";"Torino";""
"2014";" 001272 ";"TORINO";"PIAZZA FORONI";"Mercato";"lun. mar. mer. gio. ven. sab.";"Settimanale";"Annuale";"0";"76";"69";"7";"152";"0";"19";"32";"13";"64";"216";"Torino";""
"2014";" 001272 ";"TORINO";"PIAZZA DELLA REPUBBLICA";"Mercato";"lun. mar. mer. gio. ven. sab.";"Settimanale";"Annuale";"0";"404";"429";"90";"923";"0";"24";"11";"12";"47";"970";"Torino";""
"2014";" 001248 ";"SAN MAURIZIO CANAVESE";"P.ZZA DEGLI AGRICOLTORI-FRAZ. CERETTA-";"Mercato";"sab.";"Settimanale";"Annuale";"0";"9";"11";"4";"24";"0";"0";"0";"0";"0";"24";"Torino";""
"2014";" 001249 ";"SAN MAURO TORINESE";"PIAZZA GRAMSCI";"Mercato";"lun.";"Settimanale";"Annuale";"0";"25";"56";"12";"93";"0";"1";"0";"0";"1";"94";"Torino";""
"2014";" 001257 ";"SANTENA";"P.zza Aimerito e Via Tetti Agostino";"Mercato";"gio.";"Settimanale";"Annuale";"0";"24";"65";"6";"95";"0";"0";"0";"0";"0";"95";"Torino";""
"2014";" 001265 ";"SETTIMO TORINESE";"VIA CASTIGLIONE";"Mercato";"mar.";"Settimanale";"Annuale";"0";"57";"109";"18";"184";"0";"0";"6";"0";"6";"190";"Torino";""
"2014";" 001272 ";"TORINO";"PIAZZA VITTORIA";"Mercato";"lun. mar. mer. gio. ven. sab.";"Settimanale";"Annuale";"0";"80";"72";"4";"156";"0";"5";"22";"1";"28";"184";"Torino";""
"2014";" 001280 ";"TROFARELLO";"PIAZZA I MAGGIO";"Mercato";"mer.";"Settimanale";"Annuale";"0";"27";"48";"5";"80";"1";"1";"1";"1";"4";"84";"Torino";""
"2014";" 001288 ";"VALPRATO SOANA";"PIAZZA PRINCIPALE";"Mercato";"mar.";"Settimanale";"Stagionale";"0";"2";"5";"0";"7";"0";"1";"0";"1";"2";"9";"Torino";""
"2014";" 001292 ";"VENARIA REALE";"PIAZZA DELL'ANNUNZIATA";"Posteggio isolato";"lun. mar. mer. gio. ven. sab.";"Settimanale";"Annuale";"0";"1";"0";"0";"1";"0";"0";"0";"0";"0";"1";"Torino";""
"2014";" 001247 ";"SAN MARTINO CANAVESE";"PIAZZA DELLA CHIESA";"Mercato";"gio.";"Settimanale";"Annuale";"3";"0";"0";"0";"3";"2";"0";"0";"0";"2";"5";"Torino";""
"2014";" 001265 ";"SETTIMO TORINESE";"VIA CASTIGLIONE";"Mercato";"sab.";"Settimanale";"Annuale";"0";"58";"114";"18";"190";"0";"0";"1";"1";"2";"192";"Torino";""
"2014";" 001282 ";"USSEGLIO";"PIAZZA CESARE FERRO";"Mercato";"dom.";"Settimanale";"Stagionale";"0";"4";"20";"0";"24";"0";"0";"0";"0";"0";"24";"Torino";""
"2014";" 001292 ";"VENARIA REALE";"VIALE GIORDANO BRUNO - CIMITERO GENERALE";"Posteggio isolato";"mar. mer. gio. ven. sab. dom.";"Settimanale";"Annuale";"0";"0";"1";"0";"1";"0";"0";"0";"0";"0";"1";"Torino";""
"2014";" 001243 ";"SAN GILLIO";"VIA ROMA";"Mercato";"ven.";"Settimanale";"Annuale";"0";"8";"4";"1";"13";"0";"0";"2";"0";"2";"15";"Torino";""
"2014";" 001246 ";"SAN GIUSTO CANAVESE";"PIAZZA DON SCAPINO";"Mercato";"gio.";"Settimanale";"Annuale";"0";"11";"15";"1";"27";"0";"2";"1";"0";"3";"30";"Torino";""
"2014";" 001255 ";"SANT'AMBROGIO DI TORINO";"PIAZZA DELLA REPUBBLICA";"Mercato";"sab.";"Settimanale";"Annuale";"3";"14";"17";"3";"37";"0";"0";"2";"3";"5";"42";"Torino";""
"2014";" 001272 ";"TORINO";"PIAZZA DELLA REPUBBLICA";"Mercato";"sab.";"Settimanale";"Annuale";"0";"0";"116";"0";"116";"0";"0";"42";"0";"42";"158";"Torino";""
"2014";" 001272 ";"TORINO";"PIAZZA CHIRONI";"Mercato";"lun. mar. mer. gio. ven. sab.";"Settimanale";"Annuale";"0";"0";"1";"0";"1";"0";"11";"6";"1";"18";"19";"Torino";""
"2014";" 001272 ";"TORINO";"PIAZZA SANTA GIULIA";"Mercato";"lun. mar. mer. gio. ven. sab.";"Settimanale";"Annuale";"0";"23";"15";"3";"41";"0";"6";"17";"2";"25";"66";"Torino";""
"2014";" 001272 ";"TORINO";"REG. VALLETTE";"Mercato";"lun. mar. mer. gio. ven. sab.";"Settimanale";"Annuale";"0";"1";"1";"1";"3";"0";"5";"3";"0";"8";"11";"Torino";""
"2014";" 001272 ";"TORINO";"VIA DON GRIOLI";"Mercato";"lun. mar. mer. gio. ven. sab.";"Settimanale";"Annuale";"0";"57";"46";"9";"112";"0";"12";"14";"2";"28";"140";"Torino";""
"2014";" 001272 ";"TORINO";"CORSO RACCONIGI 51";"Mercato";"lun. mar. mer. gio. ven. sab.";"Settimanale";"Annuale";"0";"23";"1";"0";"24";"0";"0";"1";"0";"1";"25";"Torino";""
"2014";" 001283 ";"VAIE";"Piazza del Priore";"Mercato";"gio.";"Settimanale";"Annuale";"0";"0";"0";"0";"0";"0";"2";"1";"0";"3";"3";"Torino";""
"2014";" 001287 ";"VALPERGA";"PIAZZA PASTORE";"Mercato";"mar.";"Settimanale";"Annuale";"0";"9";"5";"0";"14";"0";"3";"2";"0";"5";"19";"Torino";""
"2014";" 001292 ";"VENARIA REALE";"ADIACENZE PARCO REGIONALE ""LA MANDRIA"" PONTE VERDE";"Posteggio isolato";"sab. dom.";"Settimanale";"Annuale";"0";"0";"0";"0";"0";"0";"1";"0";"0";"1";"1";"Torino";""
"2014";" 001241 ";"SANGANO";"PIAZZA MARCO MATTA SANGANO";"Mercato";"ven.";"Settimanale";"Annuale";"0";"12";"18";"6";"36";"0";"0";"0";"0";"0";"36";"Torino";""
"2014";" 001243 ";"SAN GILLIO";"STRADA DRUENTO";"Posteggio isolato";"lun. mar. mer. gio. ven. sab. dom.";"Settimanale";"Stagionale";"0";"1";"0";"0";"1";"0";"0";"0";"0";"0";"1";"Torino";""
"2014";" 001254 ";"SAN SECONDO DI PINEROLO";"PIAZZA EUROPA";"Mercato";"mar.";"Settimanale";"Annuale";"0";"3";"1";"2";"6";"0";"4";"6";"2";"12";"18";"Torino";""
"2014";" 001260 ";"SCALENGHE";"VIA CAVOUR";"Mercato";"lun.";"Settimanale";"Annuale";"0";"2";"2";"0";"4";"10";"0";"0";"2";"12";"16";"Torino";""
"2014";" 001265 ";"SETTIMO TORINESE";"VIA FANTINA";"Mercato";"mer.";"Settimanale";"Annuale";"0";"17";"24";"2";"43";"0";"12";"17";"1";"30";"73";"Torino";""
"2014";" 001272 ";"TORINO";"REG. CROCETTA";"Mercato";"lun. mar. mer. gio. ven. sab.";"Settimanale";"Annuale";"0";"27";"112";"3";"142";"0";"15";"7";"0";"22";"164";"Torino";""
"2014";" 001272 ";"TORINO";"REG. MIRAFIORI SUD";"Mercato";"lun. mar. mer. gio. ven. sab.";"Settimanale";"Annuale";"0";"3";"0";"0";"3";"0";"16";"33";"4";"53";"56";"Torino";""
"2014";" 001272 ";"TORINO";"PIAZZA GUALA";"Mercato";"mar. gio. sab.";"Settimanale";"Annuale";"0";"19";"27";"6";"52";"0";"20";"25";"3";"48";"100";"Torino";""
"2014";" 001272 ";"TORINO";"VIA DON MICHELE RUA";"Mercato";"lun. mar. mer. gio. ven. sab.";"Settimanale";"Annuale";"0";"5";"0";"2";"7";"0";"7";"15";"2";"24";"31";"Torino";""
"2014";" 001275 ";"TORRE PELLICE";"p.za Cavour Gianavello San Martino Micca Via Arnaud Corso Gramsci Repubblica";"Mercato";"ven.";"Settimanale";"Annuale";"0";"14";"49";"28";"91";"0";"6";"5";"1";"12";"103";"Torino";""
"2014";" 001280 ";"TROFARELLO";"PIAZZA I MAGGIO";"Posteggio isolato";"sab.";"Settimanale";"Annuale";"0";"1";"0";"0";"1";"0";"0";"0";"0";"0";"1";"Torino";""
"2014";" 001284 ";"VAL DELLA TORRE";"PIAZZA SANTA MARIA DELLA SPINA";"Posteggio isolato";"ven.";"Settimanale";"Annuale";"0";"1";"0";"0";"1";"0";"0";"0";"0";"0";"1";"Torino";""
"2014";" 001286 ";"VALLO TORINESE";"PIAZZA SAN SECONDO";"Mercato";"dom.";"Quindicinale";"Annuale";"0";"2";"0";"1";"3";"0";"0";"3";"1";"4";"7";"Torino";""
"2014";" 001291 ";"VENAUS";"VIA ANTICA REALE";"Mercato";"ven.";"Settimanale";"Annuale";"0";"4";"1";"1";"6";"6";"0";"0";"0";"6";"12";"Torino";""
"2014";" 001292 ";"VENARIA REALE";"ADIACENZE JUVENTUS STADIUM";"Posteggio isolato";"dom.";"Settimanale";"Annuale";"0";"0";"0";"0";"0";"0";"0";"1";"0";"1";"1";"Torino";""
"2014";" 001292 ";"VENARIA REALE";"PIAZZA NENNI";"Posteggio isolato";"gio.";"Settimanale";"Annuale";"0";"0";"0";"0";"0";"0";"0";"0";"1";"1";"1";"Torino";""
"2014";" 001257 ";"SANTENA";"Via Trinita' - entrata campi sportivi -";"Mercato";"lun.";"Settimanale";"Annuale";"10";"0";"0";"1";"11";"21";"0";"0";"0";"21";"32";"Torino";""
"2014";" 001270 ";"SUSA";"PIAZZA DELLA REPUBBLICA";"Mercato";"mar.";"Settimanale";"Annuale";"0";"25";"85";"13";"123";"0";"1";"13";"5";"19";"142";"Torino";""
"2014";" 001272 ";"TORINO";"PIAZZA CAMPANELLA";"Mercato";"lun. mar. mer. gio. ven. sab.";"Settimanale";"Annuale";"0";"12";"4";"3";"19";"0";"4";"19";"0";"23";"42";"Torino";""
"2014";" 001272 ";"TORINO";"PIAZZA CRISPI";"Mercato";"lun. mar. mer. gio. ven. sab.";"Settimanale";"Annuale";"0";"0";"2";"0";"2";"0";"18";"21";"4";"43";"45";"Torino";""
"2014";" 001272 ";"TORINO";"VIA DEGLI ABETI";"Mercato";"mar. gio.";"Settimanale";"Annuale";"0";"1";"0";"0";"1";"0";"10";"8";"5";"23";"24";"Torino";""
"2014";" 001279 ";"TRAVES";"PIAZZA DEI CADUTI";"Mercato";"ven.";"Settimanale";"Annuale";"0";"2";"2";"0";"4";"0";"0";"5";"0";"5";"9";"Torino";""
"2014";" 001280 ";"TROFARELLO";"PIAZZA DON MURIALDO FRAZ, VALLE SAUGLIO";"Mercato";"sab.";"Settimanale";"Annuale";"0";"3";"3";"4";"10";"0";"2";"2";"1";"5";"15";"Torino";""
"2014";" 001292 ";"VENARIA REALE";"PIAZZA NENNI";"Mercato";"mar.";"Settimanale";"Annuale";"0";"11";"16";"2";"29";"0";"2";"5";"1";"8";"37";"Torino";""
"2014";" 001292 ";"VENARIA REALE";"ADIACENZE JUVENTUS STADIUM";"Posteggio isolato";"dom.";"Settimanale";"Annuale";"0";"0";"1";"0";"1";"0";"0";"0";"0";"0";"1";"Torino";""
"2014";" 001272 ";"TORINO";"VIA SANTA RITA";"Mercato";"lun. mar. mer. gio. ven. sab.";"Settimanale";"Annuale";"0";"58";"104";"5";"167";"0";"0";"5";"0";"5";"172";"Torino";""
"2014";" 001278 ";"TRAVERSELLA";"PIAZZA CAVOUR";"Mercato";"gio.";"Settimanale";"Annuale";"0";"2";"3";"0";"5";"0";"0";"0";"0";"0";"5";"Torino";""
"2014";" 001292 ";"VENARIA REALE";"PIAZZA DON ALBERIONE";"Mercato";"ven.";"Settimanale";"Annuale";"0";"10";"7";"0";"17";"0";"4";"3";"0";"7";"24";"Torino";""
"2014";" 001292 ";"VENARIA REALE";"ADIACENZE JUVENTUS STADIUM";"Posteggio isolato";"dom.";"Settimanale";"Annuale";"0";"0";"1";"0";"1";"0";"0";"0";"0";"0";"1";"Torino";""
"2014";" 001292 ";"VENARIA REALE";"ADIACENZE JUVENTUS STADIUM";"Posteggio isolato";"dom.";"Settimanale";"Annuale";"0";"1";"0";"0";"1";"0";"0";"0";"0";"0";"1";"Torino";""
"2014";" 001244 ";"SAN GIORGIO CANAVESE";"PIAZZA MATTEO PESCATORE - VIA CAVOUR - VIA CAMPEGGIO";"Mercato";"mar.";"Settimanale";"Annuale";"24";"9";"0";"2";"35";"0";"0";"0";"0";"0";"35";"Torino";""
"2014";" 001265 ";"SETTIMO TORINESE";"VIA MILANO INTERNO PARCHEGGIO";"Posteggio isolato";"lun. mar. mer. gio. ven. sab. dom.";"Settimanale";"Stagionale";"0";"1";"0";"0";"1";"0";"0";"0";"0";"0";"1";"Torino";""
"2014";" 001267 ";"SPARONE";"PIAZZA MUNICIPALE N.1";"Mercato";"dom.";"Settimanale";"Annuale";"2";"4";"4";"0";"10";"2";"6";"2";"10";"20";"30";"Torino";""
"2014";" 001269 ";"STRAMBINO";"area mercatale attrezzata di Via Cotonificio";"Mercato";"gio.";"Settimanale";"Annuale";"0";"20";"37";"10";"67";"0";"4";"6";"5";"15";"82";"Torino";""
"2014";" 001272 ";"TORINO";"CORSO GROSSETO";"Mercato";"lun. mar. mer. gio. ven. sab.";"Settimanale";"Annuale";"0";"7";"2";"0";"9";"0";"2";"0";"0";"2";"11";"Torino";""
"2014";" 001272 ";"TORINO";"REG. FALCHERA";"Mercato";"mer.";"Settimanale";"Annuale";"0";"4";"11";"0";"15";"0";"0";"0";"0";"0";"15";"Torino";""
"2014";" 001272 ";"TORINO";"LARGO CASALE";"Mercato";"lun. mar. mer. gio. ven. sab.";"Settimanale";"Annuale";"0";"12";"37";"12";"61";"0";"1";"13";"1";"15";"76";"Torino";""
"2014";" 001272 ";"TORINO";"LUCENTO";"Mercato";"lun. mar. mer. gio. ven. sab.";"Settimanale";"Annuale";"0";"2";"0";"0";"2";"0";"4";"1";"1";"6";"8";"Torino";""
"2014";" 001272 ";"TORINO";"VIA MARTINI";"Mercato";"lun. mar. mer. gio. ven. sab.";"Settimanale";"Annuale";"0";"17";"96";"7";"120";"0";"3";"8";"0";"11";"131";"Torino";""
"2014";" 001292 ";"VENARIA REALE";"ADIACENZE JUVENTUS STADIUM";"Posteggio isolato";"dom.";"Settimanale";"Annuale";"0";"0";"1";"0";"1";"0";"0";"0";"0";"0";"1";"Torino";""
"2014";" 001265 ";"SETTIMO TORINESE";"VIA EINAUDI";"Mercato";"gio.";"Settimanale";"Annuale";"0";"38";"59";"7";"104";"0";"2";"1";"0";"3";"107";"Torino";""
"2014";" 001272 ";"TORINO";"CORSO CHIETI";"Mercato";"lun. mar. mer. gio. ven. sab.";"Settimanale";"Annuale";"0";"16";"12";"5";"33";"0";"0";"7";"0";"7";"40";"Torino";""
"2014";" 001272 ";"TORINO";"VIA PORPORA";"Mercato";"lun. mar. mer. gio. ven. sab.";"Settimanale";"Annuale";"0";"48";"36";"8";"92";"0";"0";"11";"4";"15";"107";"Torino";""
"2014";" 001284 ";"VAL DELLA TORRE";"VIA GIBBIONE";"Mercato";"sab.";"Settimanale";"Annuale";"0";"3";"2";"0";"5";"0";"0";"0";"0";"0";"5";"Torino";""
"2014";" 001292 ";"VENARIA REALE";"VIA DIAZ";"Mercato";"lun.";"Settimanale";"Annuale";"0";"8";"11";"0";"19";"0";"10";"5";"0";"15";"34";"Torino";""
"2014";" 001292 ";"VENARIA REALE";"PIAZZA DE GASPERI";"Mercato";"gio.";"Settimanale";"Annuale";"0";"34";"30";"1";"65";"0";"4";"0";"2";"6";"71";"Torino";""
"2014";" 001292 ";"VENARIA REALE";"PIAZZA NENNI";"Posteggio isolato";"gio.";"Settimanale";"Annuale";"0";"0";"0";"1";"1";"0";"0";"0";"0";"0";"1";"Torino";""
"2014";" 001292 ";"VENARIA REALE";"ADIACENZE PARCO REGIONALE ""LA MANDRIA"" PONTE VERDE";"Posteggio isolato";"sab. dom.";"Settimanale";"Annuale";"0";"0";"0";"0";"0";"0";"1";"0";"0";"1";"1";"Torino";""
"2014";" 001292 ";"VENARIA REALE";"PIAZZA NENNI";"Posteggio isolato";"ven.";"Settimanale";"Annuale";"0";"1";"0";"0";"1";"0";"0";"0";"0";"0";"1";"Torino";""
"2014";" 001242 ";"SAN GERMANO CHISONE";"PIAZZA MARTIRI DELLA LIBERTA'";"Mercato";"ven.";"Settimanale";"Annuale";"0";"2";"1";"1";"4";"1";"0";"2";"0";"3";"7";"Torino";""
"2014";" 001260 ";"SCALENGHE";"SCALENGHE VIOTTO - VIA PISCINA FRONTE CHIESA";"Posteggio isolato";"lun.";"Settimanale";"Annuale";"0";"0";"0";"0";"0";"1";"0";"0";"0";"1";"1";"Torino";""
"2014";" 001272 ";"TORINO";"VALLETTE";"Mercato";"lun. mar. mer. gio. ven. sab.";"Settimanale";"Annuale";"0";"15";"12";"0";"27";"0";"0";"2";"0";"2";"29";"Torino";""
"2014";" 001292 ";"VENARIA REALE";"PIAZZA DE GASPERI";"Mercato";"mar.";"Settimanale";"Annuale";"0";"19";"16";"1";"36";"0";"1";"1";"1";"3";"39";"Torino";""
"2014";" 001292 ";"VENARIA REALE";"PIAZZA NENNI";"Posteggio isolato";"mer.";"Settimanale";"Annuale";"0";"1";"0";"0";"1";"0";"0";"0";"0";"0";"1";"Torino";""
"2014";" 001292 ";"VENARIA REALE";"PIAZZA NENNI";"Posteggio isolato";"mer.";"Settimanale";"Annuale";"0";"0";"0";"0";"0";"0";"1";"0";"0";"1";"1";"Torino";""
"2014";" 001300 ";"VILLAFRANCA PIEMONTE";"piazza Cavour (Ala Comunale)";"Posteggio isolato";"lun. mar. mer. gio. ven. sab. dom.";"Settimanale";"Stagionale";"0";"1";"0";"0";"1";"0";"0";"0";"0";"0";"1";"Torino";""
"2014";" 002016 ";"BORGOSESIA";"piazza Mazzini, piazza Martiri, via Combattenti";"Mercato";"sab.";"Settimanale";"Annuale";"0";"22";"66";"4";"92";"0";"1";"11";"0";"12";"104";"Vercelli";""
"2014";" 002017 ";"BORGO VERCELLI";"PIAZZA XX SETTEMBRE";"Mercato";"mer.";"Settimanale";"Annuale";"0";"6";"2";"1";"9";"0";"0";"4";"0";"4";"13";"Vercelli";""
"2014";" 002021 ";"BURONZO";"PIAZZA COLONNELLO GIOVANNI SOLANO";"Mercato";"sab.";"Settimanale";"Annuale";"0";"7";"1";"1";"9";"1";"0";"3";"1";"5";"14";"Vercelli";""
"2014";" 002142 ";"STROPPIANA";"PIAZZA LIBERTA'";"Mercato";"sab.";"Settimanale";"Annuale";"0";"4";"2";"0";"6";"0";"3";"2";"1";"6";"12";"Vercelli";""
"2014";" 003001 ";"AGRATE CONTURBIA";"PIAZZA COLLOBBIANO";"Posteggio isolato";"mer.";"Settimanale";"Annuale";"0";"1";"0";"0";"1";"0";"0";"0";"0";"0";"1";"Novara";""
"2014";" 003006 ";"ARMENO";"Piazza Vittoria, Via Cavour";"Mercato";"sab.";"Settimanale";"Annuale";"0";"2";"7";"2";"11";"0";"0";"7";"1";"8";"19";"Novara";""
"2014";" 003032 ";"CAMERI";"PIAZZALE SALVO D'ACQUISTO";"Posteggio isolato";"lun. mar. mer. gio. ven. sab. dom.";"Settimanale";"Annuale";"0";"0";"1";"0";"1";"0";"0";"0";"0";"0";"1";"Novara";""
"2014";" 003045 ";"CAVAGLIO D'AGOGNA";"VIA ROMA";"Mercato";"ven.";"Settimanale";"Annuale";"0";"2";"2";"0";"4";"0";"0";"0";"0";"0";"4";"Novara";""
"2014";" 003051 ";"COLAZZA";"piazza Milano";"Mercato";"lun.";"Settimanale";"Stagionale";"0";"3";"3";"0";"6";"0";"0";"0";"0";"0";"6";"Novara";""
"2014";" 003058 ";"CUREGGIO";"P.zza C. Battisti";"Mercato";"sab.";"Settimanale";"Annuale";"0";"3";"6";"1";"10";"0";"0";"0";"0";"0";"10";"Novara";""
"2014";" 003116 ";"PETTENASCO";"Piazza Unitï¿½ d'Itlia";"Mercato";"mar.";"Settimanale";"Annuale";"5";"2";"2";"1";"10";"0";"0";"0";"1";"1";"11";"Novara";""
"2014";" 003131 ";"ROMENTINO";"PIAZZA BONOMI";"Mercato";"gio.";"Settimanale";"Annuale";"0";"7";"11";"1";"19";"0";"0";"1";"0";"1";"20";"Novara";""
"2014";" 003139 ";"SIZZANO";"PIAZZA PRONE";"Mercato";"ven.";"Settimanale";"Annuale";"0";"2";"0";"0";"2";"4";"0";"0";"1";"5";"7";"Novara";""
"2014";" 004003 ";"ALBA";"PIAZZA CAGNASSO";"Mercato";"mar.";"Settimanale";"Annuale";"0";"14";"19";"12";"45";"17";"0";"0";"48";"65";"110";"Cuneo";""
"2014";" 004033 ";"BROSSASCO";"PIAZZA DELLA LIBERTA'";"Mercato";"mer.";"Settimanale";"Annuale";"0";"1";"0";"0";"1";"0";"3";"4";"2";"9";"10";"Cuneo";""
"2014";" 004059 ";"CAVALLERMAGGIORE";"PIAZZALE EINAUDI";"Mercato";"dom.";"Settimanale";"Annuale";"10";"0";"0";"0";"10";"0";"0";"0";"0";"0";"10";"Cuneo";""
"2014";" 001313 ";"VIU'";"PIAZZA MERCATO - VIA TORINO";"Mercato";"lun.";"Settimanale";"Annuale";"0";"6";"11";"1";"18";"0";"0";"1";"0";"1";"19";"Torino";""
"2014";" 002049 ";"CRESCENTINO";"LOCALITA' CENTRO STORICO";"Mercato";"ven.";"Settimanale";"Annuale";"5";"35";"82";"4";"126";"0";"0";"0";"0";"0";"126";"Vercelli";""
"2014";" 002071 ";"LIVORNO FERRARIS";"PIAZZA POSSIS - VIALE IV NOVEMBRE - VIA SISMODI";"Mercato";"sab.";"Settimanale";"Annuale";"0";"16";"44";"3";"63";"0";"0";"19";"0";"19";"82";"Vercelli";""
"2014";" 002107 ";"QUARONA";"P.za Combattenti";"Mercato";"mer.";"Settimanale";"Annuale";"0";"5";"16";"1";"22";"0";"0";"1";"0";"1";"23";"Vercelli";""
"2014";" 002133 ";"SANTHIA'";"PIAZZA ZAPELLONI";"Mercato";"mar.";"Settimanale";"Annuale";"0";"30";"83";"5";"118";"0";"1";"2";"0";"3";"121";"Vercelli";""
"2014";" 002142 ";"STROPPIANA";"PIAZZA LIBERTA'";"Mercato";"mar.";"Settimanale";"Annuale";"0";"6";"4";"0";"10";"0";"3";"1";"1";"5";"15";"Vercelli";""
"2014";" 002158 ";"VERCELLI";"P.ZZA MAZZINI";"Mercato";"lun. mar. mer. gio. ven. sab.";"Settimanale";"Annuale";"0";"11";"0";"3";"14";"0";"4";"0";"0";"4";"18";"Vercelli";""
"2014";" 003041 ";"CASALVOLONE";"PIAZZA CASTELLO";"Mercato";"mar.";"Settimanale";"Annuale";"0";"5";"4";"0";"9";"0";"0";"4";"2";"6";"15";"Novara";""
"2014";" 003047 ";"CAVALLIRIO";"VIA RANZINI - VIA SAN ROCCO";"Mercato";"lun.";"Settimanale";"Annuale";"0";"2";"4";"0";"6";"0";"3";"5";"1";"9";"15";"Novara";""
"2014";" 003108 ";"OLEGGIO";"P.zza Martiri, via Roma, Via Novara, Viale Don Minzoni, Viale Mazzini, Viale Paganini";"Mercato";"lun.";"Settimanale";"Annuale";"0";"13";"124";"4";"141";"0";"7";"3";"1";"11";"152";"Novara";""
"2014";" 004025 ";"BORGO SAN DALMAZZO";"Via GIOVANNI XXIII";"Mercato";"lun.";"Settimanale";"Annuale";"0";"3";"1";"0";"4";"0";"1";"4";"2";"7";"11";"Cuneo";""
"2014";" 004029 ";"BRA";"PIAZZA XX SETTEMBRE - CORSO GARIBALDI - PIAZZA GIOLITTI";"Mercato";"mer.";"Settimanale";"Annuale";"0";"12";"35";"31";"78";"0";"2";"5";"0";"7";"85";"Cuneo";""
"2014";" 001292 ";"VENARIA REALE";"ADIACENZE JUVENTUS STADIUM";"Posteggio isolato";"dom.";"Settimanale";"Annuale";"0";"0";"1";"0";"1";"0";"0";"0";"0";"0";"1";"Torino";""
"2014";" 001297 ";"VICO CANAVESE";"Via Campolungo";"Mercato";"lun.";"Settimanale";"Annuale";"0";"5";"1";"0";"6";"0";"0";"0";"1";"1";"7";"Torino";""
"2014";" 002002 ";"ALAGNA VALSESIA";"PIAZZA CIRCONVALLAZIONE";"Mercato";"gio.";"Settimanale";"Stagionale";"0";"5";"28";"1";"34";"0";"0";"0";"0";"0";"34";"Vercelli";""
"2014";" 002093 ";"PEZZANA";"PIAZZA LIBERTA'";"Mercato";"mer.";"Settimanale";"Annuale";"0";"3";"1";"0";"4";"0";"1";"2";"1";"4";"8";"Vercelli";""
"2014";" 003115 ";"PELLA";"PIAZZA MOTTA";"Posteggio isolato";"dom.";"Settimanale";"Stagionale";"1";"0";"0";"0";"1";"0";"0";"0";"0";"0";"1";"Novara";""
"2014";" 004041 ";"CARAMAGNA PIEMONTE";"Piazza Castello";"Mercato";"ven.";"Settimanale";"Annuale";"0";"6";"4";"1";"11";"0";"0";"0";"0";"0";"11";"Cuneo";""
"2014";" 004049 ";"CASTELLETTO STURA";"Piazza degli Spiantati";"Mercato";"sab.";"Settimanale";"Annuale";"0";"3";"1";"1";"5";"2";"4";"2";"1";"9";"14";"Cuneo";""
"2014";" 004059 ";"CAVALLERMAGGIORE";"VIA ROMA";"Mercato";"lun.";"Settimanale";"Annuale";"0";"8";"29";"2";"39";"0";"1";"6";"3";"10";"49";"Cuneo";""
"2014";" 002015 ";"BORGO D'ALE";"PIAZZA VERDI";"Mercato";"sab.";"Settimanale";"Annuale";"0";"5";"4";"1";"10";"0";"0";"4";"0";"4";"14";"Vercelli";""
"2014";" 002071 ";"LIVORNO FERRARIS";"VIA SALUGGIA";"Posteggio isolato";"lun. mar. mer. gio. ven. sab.";"Settimanale";"Annuale";"0";"0";"1";"0";"1";"0";"0";"0";"0";"0";"1";"Vercelli";""
"2014";" 002102 ";"POSTUA";"PIAZZA DELLE SCUOLE";"Mercato";"gio.";"Settimanale";"Annuale";"0";"0";"0";"0";"0";"3";"0";"0";"0";"3";"3";"Vercelli";""
"2014";" 002150 ";"TRONZANO VERCELLESE";"VIA SANTHIA'";"Mercato";"gio.";"Settimanale";"Annuale";"0";"11";"9";"1";"21";"0";"3";"10";"0";"13";"34";"Vercelli";""
"2014";" 003008 ";"ARONA";"PIAZZA SAN ROCCO";"Mercato";"gio.";"Settimanale";"Annuale";"0";"0";"0";"0";"0";"0";"2";"1";"0";"3";"3";"Novara";""
"2014";" 003106 ";"NOVARA";"P.ZZA DONATELLO";"Mercato";"lun. mar. mer. gio. ven. sab.";"Settimanale";"Annuale";"0";"0";"0";"0";"0";"6";"0";"0";"0";"6";"6";"Novara";""
"2014";" 003133 ";"SAN MAURIZIO D'OPAGLIO";"Piazza I Maggio";"Mercato";"mar.";"Settimanale";"Annuale";"2";"4";"5";"1";"12";"0";"0";"0";"0";"0";"12";"Novara";""
"2014";" 004025 ";"BORGO SAN DALMAZZO";"Via VALDIERI";"Mercato";"sab.";"Settimanale";"Annuale";"0";"0";"0";"0";"0";"0";"3";"3";"0";"6";"6";"Cuneo";""
"2014";" 001306 ";"VILLAR PELLICE";"PARCO PUBBLICO FLISSIA";"Posteggio isolato";"mar. gio. sab. dom.";"Settimanale";"Annuale";"0";"0";"0";"0";"0";"0";"0";"0";"1";"1";"1";"Torino";""
"2014";" 001306 ";"VILLAR PELLICE";"VIA FOURCA";"Posteggio isolato";"mar. gio. sab. dom.";"Settimanale";"Annuale";"0";"0";"0";"0";"0";"0";"0";"0";"1";"1";"1";"Torino";""
"2014";" 002006 ";"ARBORIO";"PIAZZA DOMENICO MARCHETTI";"Mercato";"lun.";"Settimanale";"Annuale";"0";"3";"2";"0";"5";"0";"1";"3";"1";"5";"10";"Vercelli";""
"2014";" 002011 ";"BIANZE'";"Piazza Sant'Eusebio - Via Massimo d'Azeglio";"Mercato";"lun.";"Settimanale";"Annuale";"0";"6";"5";"0";"11";"0";"3";"13";"0";"16";"27";"Vercelli";""
"2014";" 002088 ";"OLCENENGO";"PIAZZA PAIETTA";"Posteggio isolato";"sab.";"Settimanale";"Annuale";"0";"0";"0";"0";"0";"0";"0";"1";"0";"1";"1";"Vercelli";""
"2014";" 002152 ";"VALDUGGIA";"PIAZZA FALDA - PIAZZA G. FERRARI";"Mercato";"gio.";"Settimanale";"Annuale";"0";"5";"1";"0";"6";"0";"5";"7";"0";"12";"18";"Vercelli";""
"2014";" 002158 ";"VERCELLI";"P.ZZA CAVOUR";"Mercato";"mar. ven.";"Settimanale";"Annuale";"0";"11";"114";"0";"125";"0";"0";"6";"0";"6";"131";"Vercelli";""
"2014";" 003008 ";"ARONA";"VIALE CROCE ROSSA";"Mercato";"ven.";"Settimanale";"Annuale";"0";"4";"2";"1";"7";"0";"1";"0";"1";"2";"9";"Novara";""
"2014";" 003036 ";"CARPIGNANO SESIA";"Piazze Liberta', Piazza Marconi e Via Dante";"Mercato";"mer.";"Settimanale";"Annuale";"0";"7";"29";"1";"37";"0";"1";"4";"0";"5";"42";"Novara";""
"2014";" 003076 ";"GOZZANO";"PIAZZA FERRINI";"Mercato";"mar.";"Settimanale";"Annuale";"0";"0";"0";"0";"0";"2";"0";"0";"0";"2";"2";"Novara";""
"2014";" 003077 ";"GRANOZZO CON MONTICELLO";"AREA PARCHEGGIO VIA SETTE MARTIRI";"Mercato";"gio.";"Settimanale";"Annuale";"2";"0";"0";"0";"2";"6";"0";"0";"0";"6";"8";"Novara";""
"2014";" 003088 ";"MAGGIORA";"piazza Antonelli";"Mercato";"mer.";"Settimanale";"Annuale";"0";"2";"0";"0";"2";"0";"0";"0";"0";"0";"2";"Novara";""
"2014";" 003106 ";"NOVARA";"VIA REDIPUGLIA ANG. VIA AQUILEIA";"Mercato";"lun. mar. mer. gio. ven. sab.";"Settimanale";"Annuale";"0";"0";"0";"0";"0";"3";"0";"0";"0";"3";"3";"Novara";""
"2014";" 003149 ";"TRECATE";"VIA FERRARIS";"Mercato";"sab.";"Settimanale";"Annuale";"0";"0";"0";"0";"0";"0";"1";"0";"1";"2";"2";"Novara";""
"2014";" 003158 ";"VESPOLATE";"Largo Matteotti";"Mercato";"mar.";"Settimanale";"Annuale";"0";"5";"17";"0";"22";"0";"0";"0";"0";"0";"22";"Novara";""
"2014";" 004011 ";"BARBARESCO";"PIAZZA DEL MUNICIPIO";"Mercato";"dom.";"Settimanale";"Annuale";"0";"2";"2";"0";"4";"1";"0";"0";"0";"1";"5";"Cuneo";""
"2014";" 004019 ";"BENE VAGIENNA";"P.ZZA BOTERO - P.ZZA S. FRANCESCO - V. ROMA - V. GAZZERA";"Mercato";"ven.";"Settimanale";"Annuale";"0";"10";"26";"3";"39";"0";"0";"3";"2";"5";"44";"Cuneo";""
"2014";" 004045 ";"CASALGRASSO";"PIAZZA ANUNZIATA";"Mercato";"mar.";"Settimanale";"Annuale";"0";"5";"4";"1";"10";"0";"4";"2";"1";"7";"17";"Cuneo";""
"2014";" 001293 ";"VEROLENGO";"piazza della Vittoria";"Mercato";"sab.";"Settimanale";"Annuale";"0";"4";"2";"0";"6";"0";"7";"17";"3";"27";"33";"Torino";""
"2014";" 001310 ";"VIRLE PIEMONTE";"VIA CONTESSA BIRAGO";"Mercato";"sab.";"Settimanale";"Annuale";"0";"2";"3";"1";"6";"2";"2";"3";"2";"9";"15";"Torino";""
"2014";" 001314 ";"VOLPIANO";"PIAZZA MADONNA DELLE GRAZIE";"Mercato";"sab.";"Settimanale";"Annuale";"0";"14";"17";"3";"34";"0";"0";"6";"0";"6";"40";"Torino";""
"2014";" 002059 ";"FORMIGLIANA";"PIAZZA EUROPA";"Mercato";"mer.";"Settimanale";"Annuale";"0";"2";"1";"0";"3";"3";"1";"0";"2";"6";"9";"Vercelli";""
"2014";" 002128 ";"SALUGGIA";"PIAZZA PARROCCHIALE";"Mercato";"gio.";"Settimanale";"Annuale";"0";"3";"1";"0";"4";"0";"0";"0";"0";"0";"4";"Vercelli";""
"2014";" 002148 ";"TRINO";"C.SO ITALIA/LARGO GEISENHEIM/PIAZZA MAZZINI";"Mercato";"mer.";"Settimanale";"Annuale";"27";"0";"0";"0";"27";"3";"0";"0";"0";"3";"30";"Vercelli";""
"2014";" 002158 ";"VERCELLI";"RIONE ISOLA";"Posteggio isolato";"lun. mar. mer. gio. ven. sab.";"Settimanale";"Annuale";"0";"1";"0";"0";"1";"0";"0";"0";"0";"0";"1";"Vercelli";""
"2014";" 003008 ";"ARONA";"PIAZZA PRINCIPALE";"Mercato";"gio.";"Settimanale";"Annuale";"0";"0";"0";"0";"0";"4";"0";"0";"0";"4";"4";"Novara";""
"2014";" 003012 ";"BARENGO";"Loc. Piazza delle ex Scuole in Via P. Bellini n. 25";"Mercato";"mar. gio.";"Settimanale";"Annuale";"0";"2";"0";"0";"2";"0";"1";"4";"0";"5";"7";"Novara";""
"2014";" 003040 ";"CASALINO";"cameriano piazza mercato";"Mercato";"mer.";"Settimanale";"Annuale";"4";"0";"0";"0";"4";"7";"0";"0";"1";"8";"12";"Novara";""
"2014";" 003100 ";"MOMO";"P.zza Liberta'";"Mercato";"sab.";"Settimanale";"Annuale";"0";"2";"6";"0";"8";"0";"0";"0";"0";"0";"8";"Novara";""
"2014";" 003106 ";"NOVARA";"VIA ALLA CHIESA - LUMELLOGNO";"Mercato";"lun.";"Settimanale";"Annuale";"0";"0";"2";"0";"2";"0";"0";"3";"0";"3";"5";"Novara";""
"2014";" 003108 ";"OLEGGIO";"Via Mezzomerico (P.le Cimitero)";"Posteggio isolato";"mer. gio. ven. sab. dom.";"Settimanale";"Annuale";"0";"0";"1";"0";"1";"0";"0";"0";"0";"0";"1";"Novara";""
"2014";" 003109 ";"OLEGGIO CASTELLO";"PIAZZA COMOLLI";"Mercato";"mer.";"Settimanale";"Annuale";"0";"2";"0";"0";"2";"12";"0";"0";"0";"12";"14";"Novara";""
"2014";" 004034 ";"BUSCA";"PZA SAVOIA - VIA UMBERTO - PZA REGINA MARGHERITA- PZA FLI MARIANO - PZA S MARIA";"Mercato";"ven.";"Settimanale";"Annuale";"0";"18";"65";"6";"89";"0";"1";"7";"4";"12";"101";"Cuneo";""
"2014";" 001293 ";"VEROLENGO";"piazza della Vittoria";"Mercato";"mar.";"Settimanale";"Annuale";"0";"6";"8";"2";"16";"0";"5";"11";"1";"17";"33";"Torino";""
"2014";" 001303 ";"VILLAR DORA";"PIAZZA DONATORI DI SANGUE";"Mercato";"gio.";"Settimanale";"Annuale";"5";"0";"0";"1";"6";"8";"0";"0";"1";"9";"15";"Torino";""
"2014";" 001305 ";"VILLAR FOCCHIARDO";"Piazza Abegg";"Mercato";"gio.";"Settimanale";"Annuale";"0";"4";"5";"4";"13";"4";"0";"0";"2";"6";"19";"Torino";""
"2014";" 001308 ";"VILLASTELLONE";"PIAZZA LIBERTA'";"Mercato";"lun.";"Settimanale";"Annuale";"0";"12";"26";"4";"42";"3";"0";"0";"0";"3";"45";"Torino";""
"2014";" 001315 ";"VOLVERA";"PIAZZA PERTINI";"Mercato";"lun.";"Settimanale";"Annuale";"0";"14";"40";"7";"61";"0";"0";"0";"0";"0";"61";"Torino";""
"2014";" 002057 ";"FOBELLO";"PIAZZA DEL PARCHEGGIO LUNGO LA S.P. VALMASTALLONE";"Mercato";"dom.";"Settimanale";"Stagionale";"0";"0";"2";"2";"4";"0";"0";"0";"0";"0";"4";"Vercelli";""
"2014";" 002061 ";"GATTINARA";"corsi centro storico";"Mercato";"mar.";"Settimanale";"Annuale";"0";"17";"81";"3";"101";"0";"0";"4";"0";"4";"105";"Vercelli";""
"2014";" 002158 ";"VERCELLI";"VIA MARTIRI DEL KIWU";"Mercato";"mar. ven.";"Settimanale";"Annuale";"1";"0";"0";"0";"1";"4";"0";"0";"0";"4";"5";"Vercelli";""
"2014";" 003002 ";"AMENO";"Piazza Marconi";"Mercato";"mar.";"Settimanale";"Annuale";"0";"2";"3";"0";"5";"0";"0";"0";"0";"0";"5";"Novara";""
"2014";" 003032 ";"CAMERI";"VIA SABBIONCELLI";"Mercato";"mar.";"Settimanale";"Annuale";"0";"9";"45";"0";"54";"0";"2";"0";"1";"3";"57";"Novara";""
"2014";" 003043 ";"CASTELLETTO SOPRA TICINO";"VIA CADUTI PER LA LIBERTA'";"Mercato";"sab.";"Settimanale";"Annuale";"0";"6";"11";"2";"19";"0";"2";"9";"0";"11";"30";"Novara";""
"2014";" 003103 ";"NEBBIUNO";"PIAZZA CENTRO SPORTIVO / PIAZZA IV NOVEMBRE";"Mercato";"gio.";"Settimanale";"Annuale";"0";"3";"1";"0";"4";"0";"3";"3";"2";"8";"12";"Novara";""
"2014";" 003106 ";"NOVARA";"L.GO CANTORE";"Mercato";"mer.";"Settimanale";"Annuale";"0";"0";"0";"0";"0";"2";"0";"0";"0";"2";"2";"Novara";""
"2014";" 003108 ";"OLEGGIO";"Piazzale Teatro";"Mercato";"ven.";"Settimanale";"Annuale";"0";"2";"2";"0";"4";"0";"1";"1";"0";"2";"6";"Novara";""
"2014";" 003115 ";"PELLA";"PIAZZA MOTTA";"Posteggio isolato";"dom.";"Settimanale";"Stagionale";"0";"0";"0";"0";"0";"1";"0";"0";"0";"1";"1";"Novara";""
"2014";" 003149 ";"TRECATE";"VIA MAZZINI - VIA VERDI - VIA MACALLE'-FRAZ.SAN MARTINO";"Mercato";"mer.";"Settimanale";"Annuale";"0";"17";"67";"0";"84";"0";"2";"2";"2";"6";"90";"Novara";""
"2014";" 004028 ";"BOVES";"piazza Italia";"Mercato";"sab.";"Settimanale";"Annuale";"0";"0";"36";"0";"36";"0";"0";"0";"0";"0";"36";"Cuneo";""
"2014";" 001292 ";"VENARIA REALE";"ADIACENZE JUVENTUS STADIUM";"Posteggio isolato";"dom.";"Settimanale";"Annuale";"0";"1";"0";"0";"1";"0";"0";"0";"0";"0";"1";"Torino";""
"2014";" 001311 ";"VISCHE";"PIAZZA CADUTI VISCHESI PER LA LIBERTA'";"Mercato";"mer.";"Settimanale";"Annuale";"0";"3";"2";"1";"6";"0";"0";"0";"0";"0";"6";"Torino";""
"2014";" 002007 ";"ASIGLIANO VERCELLESE";"PIAZZA DELLA CHIESA";"Mercato";"gio.";"Settimanale";"Annuale";"0";"7";"6";"0";"13";"0";"0";"0";"0";"0";"13";"Vercelli";""
"2014";" 002090 ";"PALAZZOLO VERCELLESE";"piazza giovane italia";"Mercato";"gio.";"Settimanale";"Annuale";"0";"2";"3";"0";"5";"2";"0";"1";"0";"3";"8";"Vercelli";""
"2014";" 003008 ";"ARONA";"L.GO VIDALE";"Mercato";"dom.";"Settimanale";"Stagionale";"5";"0";"0";"0";"5";"0";"0";"0";"1";"1";"6";"Novara";""
"2014";" 003060 ";"DIVIGNANO";"PIAZZA MATTEOTTI";"Posteggio isolato";"gio.";"Settimanale";"Annuale";"0";"1";"0";"0";"1";"0";"0";"0";"0";"0";"1";"Novara";""
"2014";" 003093 ";"MASSINO VISCONTI";"via viotti";"Mercato";"mer.";"Settimanale";"Annuale";"0";"3";"2";"0";"5";"0";"0";"1";"0";"1";"6";"Novara";""
"2014";" 003106 ";"NOVARA";"L.GO LEONARDI";"Mercato";"lun. mar. mer. gio. ven. sab.";"Settimanale";"Annuale";"1";"3";"12";"0";"16";"0";"0";"0";"0";"0";"16";"Novara";""
"2014";" 003106 ";"NOVARA";"VIA COLLODI ANG. VIA SFORZA - PERNATE";"Mercato";"mar. mer. gio.";"Settimanale";"Annuale";"8";"0";"0";"0";"8";"1";"0";"0";"1";"2";"10";"Novara";""
"2014";" 003112 ";"ORTA SAN GIULIO";"Piazza Motta";"Mercato";"mer.";"Settimanale";"Annuale";"0";"4";"17";"0";"21";"0";"0";"0";"0";"0";"21";"Novara";""
"2014";" 003143 ";"SUNO";"PIAZZA MARTIRI";"Mercato";"gio.";"Settimanale";"Annuale";"0";"1";"0";"0";"1";"0";"3";"5";"0";"8";"9";"Novara";""
"2014";" 004001 ";"ACCEGLIO";"PIAZZA NAIS";"Mercato";"dom.";"Settimanale";"Stagionale";"0";"5";"13";"4";"22";"0";"0";"0";"0";"0";"22";"Cuneo";""
"2014";" 004002 ";"AISONE";"AISONE - P.ZZA NUOVA";"Mercato";"mar.";"Settimanale";"Annuale";"0";"3";"1";"0";"4";"0";"0";"0";"0";"0";"4";"Cuneo";""
"2014";" 004003 ";"ALBA";"CENTRO STORICO";"Mercato";"sab.";"Settimanale";"Annuale";"2";"50";"150";"51";"253";"7";"0";"0";"9";"16";"269";"Cuneo";""
"2014";" 004016 ";"BEINETTE";"PIAZZA UMBERTO";"Mercato";"mer.";"Settimanale";"Annuale";"0";"5";"2";"0";"7";"0";"1";"4";"2";"7";"14";"Cuneo";""
"2014";" 004029 ";"BRA";"PIAZZA GIOLITTI";"Mercato";"sab.";"Settimanale";"Annuale";"0";"2";"0";"31";"33";"0";"3";"0";"0";"3";"36";"Cuneo";""
"2014";" 004037 ";"CANALE";"PIAZZA SAN BERNARDINO - PIAZZA DELLA VITTORIA";"Mercato";"dom.";"Settimanale";"Annuale";"0";"1";"9";"0";"10";"2";"0";"0";"0";"2";"12";"Cuneo";""
"2014";" 004042 ";"CARDE'";"PIAZZA MARTIRI DELLA LIBERTA'";"Mercato";"mar.";"Settimanale";"Annuale";"0";"2";"2";"0";"4";"0";"0";"1";"1";"2";"6";"Cuneo";""
"2014";" 004043 ";"CARRU'";"CAPOLUOGO";"Mercato";"gio.";"Settimanale";"Annuale";"0";"11";"48";"20";"79";"0";"4";"16";"0";"20";"99";"Cuneo";""
"2014";" 001302 ";"VILLARBASSE";"VIA MARIA VITTONE";"Mercato";"mer.";"Settimanale";"Annuale";"0";"4";"3";"1";"8";"0";"0";"1";"0";"1";"9";"Torino";""
"2014";" 001312 ";"VISTRORIO";"PIAZZA CAVOUR";"Mercato";"mer.";"Settimanale";"Annuale";"0";"6";"3";"0";"9";"0";"0";"0";"0";"0";"9";"Torino";""
"2014";" 002003 ";"ALBANO VERCELLESE";"PIAZZA ROMA";"Mercato";"gio.";"Settimanale";"Annuale";"0";"1";"1";"0";"2";"1";"1";"1";"1";"4";"6";"Vercelli";""
"2014";" 002061 ";"GATTINARA";"corso Cavour";"Mercato";"ven.";"Settimanale";"Annuale";"0";"1";"0";"0";"1";"0";"1";"0";"0";"1";"2";"Vercelli";""
"2014";" 002115 ";"RIVE";"PIAZZA XXIV MAGGIO";"Mercato";"lun.";"Settimanale";"Annuale";"0";"3";"3";"0";"6";"0";"0";"0";"0";"0";"6";"Vercelli";""
"2014";" 003049 ";"CERANO";"Piazzale ex Cotonificio Valle Ticino";"Mercato";"mar.";"Settimanale";"Annuale";"0";"15";"43";"2";"60";"0";"0";"0";"0";"0";"60";"Novara";""
"2014";" 003065 ";"FARA NOVARESE";"Piazza XXV Aprile";"Mercato";"gio.";"Settimanale";"Annuale";"0";"3";"3";"0";"6";"0";"1";"6";"1";"8";"14";"Novara";""
"2014";" 003073 ";"GHEMME";"PIAZZA CASTELLO";"Mercato";"gio.";"Settimanale";"Annuale";"0";"7";"19";"1";"27";"0";"4";"6";"1";"11";"38";"Novara";""
"2014";" 004022 ";"BERNEZZO";"P.zza Martiri della Libertï¿½";"Mercato";"mer.";"Settimanale";"Annuale";"0";"3";"0";"0";"3";"0";"0";"2";"0";"2";"5";"Cuneo";""
"2014";" 004040 ";"CARAGLIO";"VIA ROMA, PIAZZA CAVOUR, PIAZZA MADRE TERESA";"Mercato";"mer.";"Settimanale";"Annuale";"0";"22";"45";"4";"71";"0";"1";"2";"3";"6";"77";"Cuneo";""
"2014";" 001293 ";"VEROLENGO";"via Borgo nuovo vicino civico n. 2 frazione Borgo Revel";"Mercato";"mar.";"Settimanale";"Annuale";"0";"0";"0";"0";"0";"3";"0";"0";"0";"3";"3";"Torino";""
"2014";" 001294 ";"VERRUA SAVOIA";"PIAZZA SUPIANO";"Mercato";"dom.";"Settimanale";"Annuale";"2";"1";"0";"0";"3";"1";"0";"0";"2";"3";"6";"Torino";""
"2014";" 001306 ";"VILLAR PELLICE";"VIA CAVE DEL FIN";"Posteggio isolato";"mar. gio. sab. dom.";"Settimanale";"Annuale";"0";"0";"0";"0";"0";"0";"0";"0";"1";"1";"1";"Torino";""
"2014";" 001309 ";"VINOVO";"PIAZZA 2 GIUGNO E PIAZZA REY";"Mercato";"lun.";"Settimanale";"Annuale";"0";"25";"79";"9";"113";"0";"1";"0";"0";"1";"114";"Torino";""
"2014";" 002042 ";"CIGLIANO";"PIAZZA E. FERRARIS - VIA XXV APRILE - PIAZZA MARTIRI LIBERTA'";"Mercato";"gio.";"Settimanale";"Annuale";"0";"14";"49";"2";"65";"0";"0";"0";"0";"0";"65";"Vercelli";""
"2014";" 002065 ";"GREGGIO";"PIAZZA XXVII APRILE 1";"Mercato";"gio.";"Settimanale";"Annuale";"0";"3";"2";"0";"5";"0";"0";"0";"0";"0";"5";"Vercelli";""
"2014";" 002068 ";"LENTA";"PIAZZA PIGNOLO";"Mercato";"ven.";"Settimanale";"Annuale";"0";"2";"2";"0";"4";"0";"2";"3";"0";"5";"9";"Vercelli";""
"2014";" 002072 ";"LOZZOLO";"Piazza Robatti";"Mercato";"lun.";"Settimanale";"Annuale";"0";"1";"0";"0";"1";"0";"1";"2";"1";"4";"5";"Vercelli";""
"2014";" 002104 ";"PRAROLO";"via Roma";"Mercato";"mer.";"Settimanale";"Annuale";"0";"2";"0";"0";"2";"0";"1";"3";"0";"4";"6";"Vercelli";""
"2014";" 002135 ";"SCOPELLO";"PIAZZA MUNICIPIO";"Mercato";"mer.";"Settimanale";"Annuale";"0";"2";"5";"1";"8";"0";"0";"0";"0";"0";"8";"Vercelli";""
"2014";" 003006 ";"ARMENO";"VIALE CADORNA";"Posteggio isolato";"mar.";"Settimanale";"Annuale";"0";"1";"0";"0";"1";"0";"0";"0";"0";"0";"1";"Novara";""
"2014";" 003008 ";"ARONA";"C.SO REPUBBLICA";"Mercato";"mar.";"Settimanale";"Annuale";"0";"24";"168";"7";"199";"0";"3";"6";"0";"9";"208";"Novara";""
"2014";" 003070 ";"GARGALLO";"piazza dott. c.baroli";"Mercato";"mar.";"Settimanale";"Annuale";"3";"0";"0";"0";"3";"0";"2";"2";"0";"4";"7";"Novara";""
"2014";" 003106 ";"NOVARA";"V.LE DANTE N. 1";"Mercato";"lun. gio. sab.";"Settimanale";"Annuale";"0";"0";"67";"0";"67";"0";"0";"9";"0";"9";"76";"Novara";""
"2014";" 003121 ";"POMBIA";"LARGO NEGRI - P.ZZA MARTIRI";"Mercato";"sab.";"Settimanale";"Annuale";"0";"2";"0";"0";"2";"0";"3";"4";"1";"8";"10";"Novara";""
"2014";" 003122 ";"PRATO SESIA";"Piazzale adiacente Via E.De Amicis";"Mercato";"mer.";"Settimanale";"Annuale";"0";"2";"1";"0";"3";"0";"1";"2";"0";"3";"6";"Novara";""
"2014";" 004003 ";"ALBA";"PIAZZA CAGNASSO";"Mercato";"gio.";"Settimanale";"Annuale";"0";"21";"54";"21";"96";"3";"0";"0";"40";"43";"139";"Cuneo";""
"2014";" 001304 ";"VILLAREGGIA";"PIAZZA GUIDO VALLERO";"Mercato";"ven.";"Settimanale";"Annuale";"0";"2";"2";"0";"4";"0";"0";"0";"0";"0";"4";"Torino";""
"2014";" 002038 ";"CELLIO";"PIAZZA DURIO";"Mercato";"dom.";"Settimanale";"Stagionale";"1";"2";"5";"0";"8";"1";"1";"1";"1";"4";"12";"Vercelli";""
"2014";" 002054 ";"DESANA";"PIAZZA CAVOUR";"Mercato";"gio.";"Settimanale";"Annuale";"0";"3";"3";"0";"6";"0";"1";"1";"0";"2";"8";"Vercelli";""
"2014";" 002090 ";"PALAZZOLO VERCELLESE";"Piazza Giovane Italia";"Mercato";"mar.";"Settimanale";"Annuale";"0";"2";"1";"0";"3";"5";"0";"0";"0";"5";"8";"Vercelli";""
"2014";" 002122 ";"ROVASENDA";"PIAZZA LIBERTA'";"Mercato";"gio.";"Settimanale";"Annuale";"0";"2";"1";"0";"3";"0";"0";"0";"0";"0";"3";"Vercelli";""
"2014";" 002163 ";"VILLARBOIT";"Piazza IV Novembre";"Mercato";"mer.";"Settimanale";"Annuale";"0";"3";"1";"0";"4";"0";"0";"0";"0";"0";"4";"Vercelli";""
"2014";" 003027 ";"BRIONA";"VIA SOLAROLI";"Mercato";"lun.";"Settimanale";"Annuale";"0";"1";"5";"0";"6";"0";"1";"2";"0";"3";"9";"Novara";""
"2014";" 003082 ";"INVORIO";"Piazza Italia";"Mercato";"lun.";"Settimanale";"Annuale";"0";"6";"13";"0";"19";"0";"2";"3";"0";"5";"24";"Novara";""
"2014";" 003106 ";"NOVARA";"VIA BELTRAMI ANG. VIA DELLE ROSETTE";"Mercato";"mar. mer. ven.";"Settimanale";"Annuale";"2";"2";"19";"0";"23";"0";"1";"6";"0";"7";"30";"Novara";""
"2014";" 004003 ";"ALBA";"BORGO PIAVE";"Mercato";"ven.";"Settimanale";"Annuale";"0";"9";"9";"12";"30";"3";"0";"0";"0";"3";"33";"Cuneo";""
"2014";" 004027 ";"BOSSOLASCO";"C.so Paolo dellaValle";"Posteggio isolato";"sab.";"Settimanale";"Annuale";"0";"0";"1";"0";"1";"0";"0";"0";"0";"0";"1";"Cuneo";""
"2014";" 004029 ";"BRA";"PIAZZA XX SETTEMBRE - CORSO GARIBALDI - PIAZZA CARLO ALBERTO - PIAZZA GIOLI TTI";"Mercato";"ven.";"Settimanale";"Annuale";"0";"34";"136";"31";"201";"0";"2";"12";"0";"14";"215";"Cuneo";""
"2014";" 004031 ";"BRIGA ALTA";"frazione Upega";"Mercato";"dom.";"Settimanale";"Stagionale";"2";"0";"0";"0";"2";"2";"0";"0";"2";"4";"6";"Cuneo";""
"2014";" 004040 ";"CARAGLIO";"P.zza Cavour";"Posteggio isolato";"ven. sab. dom.";"Settimanale";"Annuale";"0";"1";"0";"0";"1";"0";"0";"0";"0";"0";"1";"Cuneo";""
"2014";" 004061 ";"CENTALLO";"Piazza Don Gerbaudo - d.c.c. n. 62 del 31.10.05";"Mercato";"ven.";"Settimanale";"Annuale";"0";"0";"0";"0";"0";"0";"2";"2";"0";"4";"4";"Cuneo";""
"2014";" 001307 ";"VILLAR PEROSA";"PIAZZA GROBSVILLARS Oberdendingen (D)";"Mercato";"mar.";"Settimanale";"Annuale";"0";"6";"12";"4";"22";"0";"1";"11";"0";"12";"34";"Torino";""
"2014";" 001307 ";"VILLAR PEROSA";"PIAZZA GROBVILLARS Oberdendingen (D)";"Mercato";"gio.";"Settimanale";"Annuale";"0";"8";"18";"4";"30";"0";"1";"3";"0";"4";"34";"Torino";""
"2014";" 002030 ";"CARESANA";"PIAZZA CESARE BATTISTI";"Mercato";"gio.";"Settimanale";"Annuale";"0";"2";"2";"0";"4";"0";"1";"2";"1";"4";"8";"Vercelli";""
"2014";" 002071 ";"LIVORNO FERRARIS";"VIA SALUGGIA";"Posteggio isolato";"lun. mar. mer. gio. ven. sab.";"Settimanale";"Annuale";"1";"0";"0";"0";"1";"0";"0";"0";"0";"0";"1";"Vercelli";""
"2014";" 002118 ";"RONSECCO";"PIAZZA VITTORIO VENETO";"Mercato";"ven.";"Settimanale";"Annuale";"0";"4";"2";"0";"6";"0";"1";"0";"0";"1";"7";"Vercelli";""
"2014";" 002131 ";"SAN GERMANO VERCELLESE";"PIAZZA MAZZINI";"Mercato";"lun.";"Settimanale";"Annuale";"1";"4";"7";"2";"14";"0";"1";"5";"2";"8";"22";"Vercelli";""
"2014";" 002137 ";"SERRAVALLE SESIA";"P.ZA LIBERTA' - VIALE ROMA";"Mercato";"gio.";"Settimanale";"Annuale";"0";"13";"24";"4";"41";"0";"1";"4";"2";"7";"48";"Vercelli";""
"2014";" 002148 ";"TRINO";"C.SO ITALIA/LARGO GEISENHEIM/PIAZZA MAZZINI/PIAZZA MARTIRI DELLA LIBERTA'";"Mercato";"sab.";"Settimanale";"Annuale";"50";"0";"0";"0";"50";"17";"0";"0";"0";"17";"67";"Vercelli";""
"2014";" 002164 ";"VILLATA";"PIAZZA GASTALDI - PIAZZA DARDANO - LARGO MARCONI";"Mercato";"gio.";"Settimanale";"Annuale";"0";"8";"6";"0";"14";"1";"1";"1";"1";"4";"18";"Vercelli";""
"2014";" 003016 ";"BELLINZAGO NOVARESE";"Via L. Miglio e Via V. Bovio (lato Ovest)";"Mercato";"sab.";"Settimanale";"Annuale";"0";"4";"27";"1";"32";"0";"8";"31";"0";"39";"71";"Novara";""
"2014";" 003023 ";"BORGOLAVEZZARO";"PIAZZA LIBERTA' - VIA D. RUVA";"Mercato";"sab.";"Settimanale";"Annuale";"0";"4";"6";"0";"10";"0";"0";"0";"0";"0";"10";"Novara";""
"2014";" 003068 ";"GALLIATE";"PIAZZA VITTORIO VENETO - PIAZZA MARTIRI DELLA LIBERTA'";"Mercato";"ven.";"Settimanale";"Annuale";"0";"16";"56";"2";"74";"0";"0";"0";"0";"0";"74";"Novara";""
"2014";" 003083 ";"LANDIONA";"PIAZZALE NUOVO";"Posteggio isolato";"mar.";"Settimanale";"Annuale";"0";"0";"0";"1";"1";"0";"0";"0";"0";"0";"1";"Novara";""
"2014";" 003084 ";"LESA";"Viale Vittorio Veneto";"Mercato";"gio.";"Settimanale";"Annuale";"0";"6";"18";"1";"25";"0";"9";"9";"0";"18";"43";"Novara";""
"2014";" 003106 ";"NOVARA";"C.SO TRIESTE ANG. VIA BOVIO";"Mercato";"lun. mar. mer. gio. ven. sab.";"Settimanale";"Annuale";"4";"1";"0";"0";"5";"12";"1";"0";"2";"15";"20";"Novara";""
"2014";" 003134 ";"SAN NAZZARO SESIA";"PIAZZA VITTORIO VENETO";"Mercato";"ven.";"Settimanale";"Annuale";"0";"3";"6";"1";"10";"0";"0";"0";"0";"0";"10";"Novara";""
"2014";" 004028 ";"BOVES";"piazza Italia";"Mercato";"mer.";"Settimanale";"Annuale";"0";"0";"6";"0";"6";"0";"0";"5";"0";"5";"11";"Cuneo";""
"2014";" 004037 ";"CANALE";"VIA ROMA - P.ZZA ITALIA - VIA GRAVIER - P.ZZA MARTIRI L. - VIA MALABAILA - P.ZZA VITTORIA - P.ZZA CASTELLO";"Mercato";"mar.";"Settimanale";"Annuale";"0";"14";"45";"0";"59";"0";"0";"1";"0";"1";"60";"Cuneo";""
"2014";" 004061 ";"CENTALLO";"Piazza Vittorio Emanuele II";"Mercato";"lun.";"Settimanale";"Annuale";"2";"11";"27";"0";"40";"1";"1";"0";"4";"6";"46";"Cuneo";""
"2014";" 002114 ";"RIVA VALDOBBIA";"PIAZZA DEL MERCATO";"Mercato";"lun.";"Settimanale";"Stagionale";"0";"3";"8";"1";"12";"0";"1";"3";"0";"4";"16";"Vercelli";""
"2014";" 002134 ";"SCOPA";"PIAZZA MUNICIPIO";"Mercato";"dom.";"Settimanale";"Stagionale";"0";"0";"1";"0";"1";"0";"1";"4";"1";"6";"7";"Vercelli";""
"2014";" 002158 ";"VERCELLI";"C.SO SAN MARTINO";"Mercato";"lun. mar. mer. gio. ven. sab.";"Settimanale";"Annuale";"0";"6";"0";"1";"7";"0";"6";"0";"2";"8";"15";"Vercelli";""
"2014";" 003001 ";"AGRATE CONTURBIA";"VIA CASTELLO";"Posteggio isolato";"mar.";"Settimanale";"Annuale";"0";"1";"0";"0";"1";"0";"0";"0";"0";"0";"1";"Novara";""
"2014";" 003018 ";"BIANDRATE";"Piazza Martiri della Liberta' n. 1";"Mercato";"mar.";"Settimanale";"Annuale";"0";"4";"5";"0";"9";"0";"0";"0";"0";"0";"9";"Novara";""
"2014";" 003024 ";"BORGOMANERO";"FRAZIONE SANTA CRISTINA";"Mercato";"mar.";"Settimanale";"Annuale";"0";"1";"0";"0";"1";"0";"0";"2";"0";"2";"3";"Novara";""
"2014";" 003066 ";"FONTANETO D'AGOGNA";"piazza castello";"Mercato";"ven.";"Settimanale";"Annuale";"0";"2";"0";"0";"2";"0";"2";"4";"1";"7";"9";"Novara";""
"2014";" 003079 ";"GRIGNASCO";"PIAZZA CACCIAMI - VIA ROMA - VIA MATTEOTTI - VIA VITTORIO EMANUELE II";"Mercato";"ven.";"Settimanale";"Annuale";"0";"12";"21";"1";"34";"0";"0";"0";"0";"0";"34";"Novara";""
"2014";" 003091 ";"MARANO TICINO";"Piazzetta Nuova";"Mercato";"ven.";"Settimanale";"Annuale";"0";"1";"1";"0";"2";"0";"1";"1";"1";"3";"5";"Novara";""
"2014";" 003146 ";"TORNACO";"Piazza Libertï¿½";"Mercato";"ven.";"Settimanale";"Annuale";"1";"1";"2";"0";"4";"0";"1";"1";"0";"2";"6";"Novara";""
"2014";" 003154 ";"VARALLO POMBIA";"PIAZZA RISORGIMENTO - VARALLO POMBIA";"Mercato";"sab.";"Settimanale";"Annuale";"0";"7";"10";"1";"18";"0";"1";"5";"0";"6";"24";"Novara";""
"2014";" 004006 ";"ARGENTERA";"FRAZIONE BERSEZIO VIA NAZIONALE";"Mercato";"dom.";"Settimanale";"Stagionale";"0";"1";"6";"2";"9";"0";"0";"0";"0";"0";"9";"Cuneo";""
"2014";" 004028 ";"BOVES";"piazza dell'Olmo";"Mercato";"mer.";"Settimanale";"Annuale";"0";"6";"0";"2";"8";"0";"1";"0";"0";"1";"9";"Cuneo";""
"2014";" 004039 ";"CAPRAUNA";"Piazza S.Antonino";"Mercato";"dom.";"Quindicinale";"Stagionale";"0";"3";"1";"2";"6";"0";"0";"0";"0";"0";"6";"Cuneo";""
"2014";" 004050 ";"CASTELLETTO UZZONE";"PIAZZA LOC. PALAZZO";"Mercato";"sab.";"Settimanale";"Annuale";"0";"2";"3";"1";"6";"0";"0";"0";"0";"0";"6";"Cuneo";""
"2014";" 001295 ";"VESTIGNE'";"PIAZZA CADUTI";"Mercato";"lun.";"Settimanale";"Annuale";"0";"3";"2";"0";"5";"0";"0";"2";"2";"4";"9";"Torino";""
"2014";" 002025 ";"CAMPERTOGNO";"PIAZZA GILARDI";"Mercato";"sab.";"Settimanale";"Annuale";"0";"3";"1";"0";"4";"0";"0";"0";"0";"0";"4";"Vercelli";""
"2014";" 002071 ";"LIVORNO FERRARIS";"VIA SALUGGIA";"Posteggio isolato";"lun. mar. mer. gio. ven. sab.";"Settimanale";"Annuale";"1";"0";"0";"0";"1";"0";"0";"0";"0";"0";"1";"Vercelli";""
"2014";" 002088 ";"OLCENENGO";"Piazza Gramsci 2";"Mercato";"lun.";"Settimanale";"Annuale";"0";"0";"0";"0";"0";"2";"2";"0";"0";"4";"4";"Vercelli";""
"2014";" 002104 ";"PRAROLO";"via Roma";"Mercato";"mer. sab.";"Settimanale";"Annuale";"0";"3";"3";"0";"6";"0";"0";"0";"0";"0";"6";"Vercelli";""
"2014";" 002135 ";"SCOPELLO";"Piazza Fonderia Via Fonderia";"Mercato";"mer.";"Settimanale";"Stagionale";"0";"4";"27";"3";"34";"0";"0";"1";"0";"1";"35";"Vercelli";""
"2014";" 003083 ";"LANDIONA";"PIAZZALE NUOVO";"Posteggio isolato";"sab.";"Settimanale";"Annuale";"0";"0";"1";"0";"1";"0";"0";"0";"0";"0";"1";"Novara";""
"2014";" 003106 ";"NOVARA";"V.LEDANTE N. 1";"Mercato";"lun. mar. mer. gio. ven. sab.";"Settimanale";"Annuale";"0";"33";"0";"0";"33";"0";"17";"0";"0";"17";"50";"Novara";""
"2014";" 003106 ";"NOVARA";"V.LE DANTE 1";"Mercato";"lun. mar. mer. gio. ven. sab.";"Settimanale";"Annuale";"0";"13";"0";"0";"13";"0";"6";"0";"0";"6";"19";"Novara";""
"2014";" 003130 ";"ROMAGNANO SESIA";"Parco IV Novembre";"Mercato";"sab.";"Settimanale";"Annuale";"0";"10";"5";"2";"17";"0";"1";"2";"0";"3";"20";"Novara";""
"2014";" 004003 ";"ALBA";"BORGO MORETTA";"Mercato";"mer.";"Settimanale";"Annuale";"0";"5";"6";"8";"19";"4";"0";"0";"0";"4";"23";"Cuneo";""
"2014";" 004008 ";"BAGNASCO";"Via Nazionale";"Mercato";"lun.";"Settimanale";"Annuale";"0";"0";"1";"0";"1";"0";"2";"4";"2";"8";"9";"Cuneo";""
"2014";" 004012 ";"BARGE";"Piazza Garibaldi- Piazza S. Giovanni-L.go Cesare Battisti-P.zza Madonna-P.zza S.";"Mercato";"gio.";"Settimanale";"Annuale";"0";"8";"35";"15";"58";"0";"7";"7";"10";"24";"82";"Cuneo";""
"2014";" 004047 ";"CASTELDELFINO";"PIAZZA DAO BERNARDO EX PIAZZA MUNICIPIO";"Mercato";"gio.";"Settimanale";"Annuale";"0";"3";"0";"0";"3";"0";"0";"0";"0";"0";"3";"Cuneo";""
"2014";" 001297 ";"VICO CANAVESE";"Via Campolungo";"Mercato";"lun.";"Settimanale";"Annuale";"0";"5";"1";"0";"6";"0";"0";"0";"1";"1";"7";"Torino";""
"2014";" 001298 ";"VIDRACCO";"Via Baldissero";"Mercato";"dom.";"Quindicinale";"Stagionale";"0";"0";"0";"10";"10";"0";"0";"0";"0";"0";"10";"Torino";""
"2014";" 001300 ";"VILLAFRANCA PIEMONTE";"PIAZZA VITTORIO VENETO";"Mercato";"mar.";"Settimanale";"Annuale";"0";"17";"24";"3";"44";"0";"0";"4";"0";"4";"48";"Torino";""
"2014";" 001301 ";"VILLANOVA CANAVESE";"PIAZZALE PARCHEGGIO AREA EX POSSIO";"Mercato";"sab.";"Settimanale";"Annuale";"0";"2";"1";"0";"3";"0";"0";"0";"0";"0";"3";"Torino";""
"2014";" 001314 ";"VOLPIANO";"PIAZZA MADONNA DELLE GRAZIE";"Mercato";"mar.";"Settimanale";"Annuale";"0";"33";"77";"6";"116";"0";"1";"2";"4";"7";"123";"Torino";""
"2014";" 002004 ";"ALICE CASTELLO";"piazza del mercato";"Mercato";"sab.";"Settimanale";"Annuale";"0";"6";"7";"0";"13";"0";"1";"1";"0";"2";"15";"Vercelli";""
"2014";" 002031 ";"CARESANABLOT";"Pec Buronzina";"Mercato";"ven.";"Settimanale";"Annuale";"0";"0";"0";"0";"0";"0";"4";"6";"1";"11";"11";"Vercelli";""
"2014";" 002058 ";"FONTANETTO PO";"PIAZZA GARIBALDI";"Mercato";"mer. sab.";"Settimanale";"Annuale";"3";"4";"0";"1";"8";"2";"1";"0";"1";"4";"12";"Vercelli";""
"2014";" 002156 ";"VARALLO";"CORSO ROMA - P.ZZA VITTORIO EMANUELE II - VIA UMBERTO I - P.ZZA GARIBALDI";"Mercato";"mar.";"Settimanale";"Annuale";"0";"21";"84";"0";"105";"0";"5";"8";"3";"16";"121";"Vercelli";""
"2014";" 003024 ";"BORGOMANERO";"CORSI CITTADINI";"Mercato";"ven.";"Settimanale";"Annuale";"0";"27";"185";"4";"216";"0";"8";"7";"0";"15";"231";"Novara";""
"2014";" 003076 ";"GOZZANO";"VIA DANTE, PIAZZA MATTEOTTI, VIA GODI,VIA GENTILE";"Mercato";"sab.";"Settimanale";"Annuale";"0";"9";"25";"0";"34";"0";"2";"6";"5";"13";"47";"Novara";""
"2014";" 003106 ";"NOVARA";"V.LE DANTE 1";"Mercato";"lun. mar. mer. gio. ven. sab.";"Settimanale";"Annuale";"3";"0";"0";"6";"9";"1";"0";"0";"5";"6";"15";"Novara";""
"2014";" 004009 ";"BAGNOLO PIEMONTE";"PIAZZA SAN PIETRO E VIE LIMITROFE";"Mercato";"mer.";"Settimanale";"Annuale";"0";"13";"29";"12";"54";"0";"1";"4";"0";"5";"59";"Cuneo";""
"2014";" 004027 ";"BOSSOLASCO";"C.SO P. DELLA VALLE";"Posteggio isolato";"sab.";"Settimanale";"Annuale";"0";"0";"1";"0";"1";"0";"0";"0";"0";"0";"1";"Cuneo";""
"2014";" 004028 ";"BOVES";"piazza dell'Olmo";"Mercato";"sab.";"Settimanale";"Annuale";"1";"14";"0";"4";"19";"0";"1";"0";"0";"1";"20";"Cuneo";""
"2014";" 004028 ";"BOVES";"piazza dell'Olmo";"Mercato";"dom.";"Settimanale";"Annuale";"0";"2";"0";"0";"2";"0";"0";"0";"0";"0";"2";"Cuneo";""
"2014";" 001292 ";"VENARIA REALE";"ADIACENZE JUVENTUS STADIUM";"Posteggio isolato";"dom.";"Settimanale";"Annuale";"0";"0";"1";"0";"1";"0";"0";"0";"0";"0";"1";"Torino";""
"2014";" 001293 ";"VEROLENGO";"via dietro chiesa civico n. 1 frazione Casabianca";"Mercato";"ven.";"Settimanale";"Annuale";"2";"0";"0";"0";"2";"1";"0";"0";"0";"1";"3";"Torino";""
"2014";" 001299 ";"VIGONE";"PIAZZA CARDINAL BOETTO";"Mercato";"gio.";"Settimanale";"Annuale";"0";"22";"45";"11";"78";"0";"0";"0";"0";"0";"78";"Torino";""
"2014";" 001306 ";"VILLAR PELLICE";"PIAZZETTA ADIACENTE ALL'UFFICIO POSTALE - V.LE Iï¾°MAGGIO ANGOLO VIA ROMA";"Mercato";"gio.";"Settimanale";"Annuale";"0";"2";"0";"1";"3";"4";"0";"0";"2";"6";"9";"Torino";""
"2014";" 001309 ";"VINOVO";"PIAZZA REY";"Mercato";"sab.";"Settimanale";"Stagionale";"0";"0";"0";"5";"5";"0";"0";"0";"3";"3";"8";"Torino";""
"2014";" 002061 ";"GATTINARA";"Corso Cavour";"Mercato";"sab.";"Settimanale";"Annuale";"0";"1";"0";"1";"2";"0";"7";"0";"7";"14";"16";"Vercelli";""
"2014";" 002116 ";"ROASIO";"PIAZZA DEL MUNICIPIO";"Mercato";"gio.";"Settimanale";"Annuale";"0";"2";"1";"0";"3";"0";"2";"3";"4";"9";"12";"Vercelli";""
"2014";" 002128 ";"SALUGGIA";"PIAZZA DEL MUNICIPIO - PIAZZA SAN DONATO";"Mercato";"gio.";"Settimanale";"Annuale";"0";"15";"25";"0";"40";"0";"0";"0";"0";"0";"40";"Vercelli";""
"2014";" 003025 ";"BORGO TICINO";"PIAZZA DELLA PACE";"Mercato";"gio.";"Quindicinale";"Annuale";"0";"1";"6";"0";"7";"0";"4";"17";"1";"22";"29";"Novara";""
"2014";" 003026 ";"BRIGA NOVARESE";"Via Sant'Antonio";"Mercato";"mer.";"Settimanale";"Annuale";"0";"4";"2";"0";"6";"0";"0";"0";"0";"0";"6";"Novara";""
"2014";" 003062 ";"DORMELLETTO";"Piazza L.go Tricolore";"Mercato";"mer.";"Settimanale";"Annuale";"0";"1";"0";"0";"1";"0";"2";"4";"0";"6";"7";"Novara";""
"2014";" 003076 ";"GOZZANO";"PIAZZA FERRINI";"Mercato";"mer.";"Settimanale";"Annuale";"0";"0";"0";"0";"0";"2";"0";"0";"0";"2";"2";"Novara";""
"2014";" 003106 ";"NOVARA";"P.ZZA PASTEUR";"Mercato";"lun. mar. mer. gio. ven. sab.";"Settimanale";"Annuale";"2";"12";"15";"0";"29";"0";"0";"0";"0";"0";"29";"Novara";""
"2014";" 004025 ";"BORGO SAN DALMAZZO";"VARIE VIE E PIAZZE CENTRO CITTA'";"Mercato";"gio.";"Settimanale";"Annuale";"0";"19";"53";"5";"77";"0";"3";"3";"4";"10";"87";"Cuneo";""
"2014";" 004037 ";"CANALE";"PIAZZA DELLA VITTORIA";"Mercato";"ven.";"Settimanale";"Annuale";"0";"3";"0";"0";"3";"0";"0";"0";"0";"0";"3";"Cuneo";""
"2014";" 004089 ";"FOSSANO";"Piazza Diaz";"Mercato";"sab.";"Settimanale";"Annuale";"0";"8";"10";"25";"43";"4";"0";"0";"0";"4";"47";"Cuneo";""
"2014";" 004099 ";"GOVONE";"VIALE DEL CASTELLO";"Mercato";"mer.";"Settimanale";"Annuale";"0";"2";"3";"0";"5";"0";"0";"0";"0";"0";"5";"Cuneo";""
"2014";" 004132 ";"MONFORTE D'ALBA";"PIAZZA MONS. DALL0RTO";"Mercato";"lun.";"Settimanale";"Annuale";"0";"6";"5";"0";"11";"0";"0";"0";"0";"0";"11";"Cuneo";""
"2014";" 004205 ";"SAMPEYRE";"PIAZZA DELLA VITTORIA";"Mercato";"ven.";"Settimanale";"Annuale";"0";"15";"27";"8";"50";"0";"0";"0";"6";"6";"56";"Cuneo";""
"2014";" 004213 ";"SANTO STEFANO BELBO";"P.ZA UMBERTO I - VIA ROMA - VIA CAVOUR - VIA XX SETTEMBRE";"Mercato";"mer.";"Settimanale";"Annuale";"0";"15";"75";"7";"97";"0";"0";"10";"0";"10";"107";"Cuneo";""
"2014";" 004215 ";"SAVIGLIANO";"Piazza Santarosa";"Posteggio isolato";"lun. mer. gio. sab.";"Settimanale";"Annuale";"0";"1";"0";"0";"1";"0";"0";"0";"0";"0";"1";"Cuneo";""
"2014";" 004233 ";"VALDIERI";"FRAZIONE SANT'ANNA DI VALDIERI";"Mercato";"sab. dom.";"Settimanale";"Stagionale";"0";"0";"0";"0";"0";"0";"0";"3";"1";"4";"4";"Cuneo";""
"2014";" 004239 ";"VERNANTE";"FRAZIONE PALANFRE'";"Posteggio isolato";"dom.";"Settimanale";"Stagionale";"1";"0";"0";"0";"1";"0";"0";"0";"0";"0";"1";"Cuneo";""
"2014";" 005005 ";"ASTI";"Piazze Alfieri, P.zza Campo del Palio, P.zza liberta'";"Mercato";"mer.";"Settimanale";"Annuale";"0";"48";"246";"35";"329";"0";"28";"13";"0";"41";"370";"Asti";""
"2014";" 005005 ";"ASTI";"PIAZZA ALFIERI, PIAZZA LIBERTA'";"Mercato";"dom.";"Quindicinale";"Annuale";"0";"0";"76";"0";"76";"0";"0";"40";"0";"40";"116";"Asti";""
"2014";" 005007 ";"BALDICHIERI D'ASTI";"PIAZZA G. ROMITA";"Mercato";"ven.";"Settimanale";"Annuale";"0";"3";"2";"1";"6";"0";"1";"0";"1";"2";"8";"Asti";""
"2014";" 005118 ";"VILLANOVA D'ASTI";"pzza. Supponito - via roma ,via vittorio veneto ,via dante.via giovanni fogliato";"Mercato";"gio.";"Settimanale";"Annuale";"0";"40";"58";"7";"105";"0";"0";"0";"0";"0";"105";"Asti";""
"2014";" 005121 ";"MONTIGLIO MONFERRATO";"MONTIGLIO MONFERRATO - PIAZZA REGINA MARGHERITA";"Mercato";"ven.";"Settimanale";"Annuale";"0";"8";"8";"3";"19";"0";"2";"1";"0";"3";"22";"Asti";""
"2014";" 006001 ";"ACQUI TERME";"PIAZZA ORTO SAN PIETRO";"Mercato";"mar.";"Settimanale";"Annuale";"0";"18";"4";"0";"22";"0";"5";"0";"0";"5";"27";"Alessandria";""
"2014";" 006003 ";"ALESSANDRIA";"PIAZZA DON ANGELO CAMPORA";"Mercato";"mer.";"Settimanale";"Annuale";"0";"5";"1";"3";"9";"0";"2";"8";"0";"10";"19";"Alessandria";""
"2014";" 006003 ";"ALESSANDRIA";"Corso Crimea";"Mercato";"lun.";"Settimanale";"Annuale";"0";"0";"0";"10";"10";"0";"0";"0";"0";"0";"10";"Alessandria";""
"2014";" 004062 ";"CERESOLE ALBA";"PIAZZA VITTORIO EMANUELE";"Mercato";"mar. sab.";"Settimanale";"Annuale";"0";"0";"0";"0";"0";"6";"0";"0";"0";"6";"6";"Cuneo";""
"2014";" 004065 ";"CERVERE";"PIAZZA S. SEBASTIANO";"Mercato";"lun.";"Settimanale";"Annuale";"0";"3";"11";"2";"16";"0";"0";"0";"0";"0";"16";"Cuneo";""
"2014";" 004118 ";"MARGARITA";"Piazza Guglielmo Marconi";"Mercato";"gio.";"Settimanale";"Annuale";"0";"3";"1";"1";"5";"0";"1";"3";"3";"7";"12";"Cuneo";""
"2014";" 004121 ";"MARTINIANA PO";"VIA ROMA E P.ZA GAUTHIER";"Mercato";"mar.";"Settimanale";"Annuale";"0";"2";"1";"1";"4";"0";"0";"0";"0";"0";"4";"Cuneo";""
"2014";" 004122 ";"MELLE";"PIAZZA BOTTA";"Mercato";"mer.";"Settimanale";"Annuale";"0";"3";"0";"0";"3";"0";"0";"0";"0";"0";"3";"Cuneo";""
"2014";" 004130 ";"MONDOVI'";"PIAZZA MAGGIORE";"Mercato";"ven.";"Settimanale";"Annuale";"0";"1";"0";"1";"2";"0";"2";"3";"0";"5";"7";"Cuneo";""
"2014";" 004159 ";"PAMPARATO";"SERRA - PIAZZA CHIESA";"Mercato";"dom.";"Settimanale";"Stagionale";"0";"0";"10";"0";"10";"0";"0";"0";"0";"0";"10";"Cuneo";""
"2014";" 004183 ";"ROASCHIA";"Fraz. Tetto Chiotti";"Posteggio isolato";"mer.";"Settimanale";"Stagionale";"0";"0";"0";"0";"0";"1";"0";"0";"0";"1";"1";"Cuneo";""
"2014";" 004190 ";"ROCCAFORTE MONDOVI'";"Lurisia";"Mercato";"lun.";"Settimanale";"Stagionale";"0";"3";"6";"1";"10";"0";"2";"1";"2";"5";"15";"Cuneo";""
"2014";" 004211 ";"SANT'ALBANO STURA";"PIAZZA DEI CADUTI IN GUERRA";"Mercato";"mar.";"Settimanale";"Annuale";"0";"2";"1";"0";"3";"0";"2";"3";"1";"6";"9";"Cuneo";""
"2014";" 005005 ";"ASTI";"CORSO ALESSANDRIA PIAZZALE COOP; PIAZZALE MULTISALA";"Posteggio isolato";"lun. mar. mer. gio. ven. sab. dom.";"Settimanale";"Stagionale";"0";"0";"0";"0";"0";"0";"0";"0";"1";"1";"1";"Asti";""
"2014";" 005005 ";"ASTI";"P.zza Catena";"Mercato";"lun. mar. mer. gio. ven. sab.";"Settimanale";"Annuale";"0";"5";"1";"35";"41";"0";"4";"0";"7";"11";"52";"Asti";""
"2014";" 005005 ";"ASTI";"PIAZZA MARCONI";"Posteggio isolato";"lun. mar. mer. gio. ven. sab. dom.";"Settimanale";"Stagionale";"0";"1";"0";"0";"1";"0";"0";"0";"0";"0";"1";"Asti";""
"2014";" 005005 ";"ASTI";"CORSO ALESSANDRIA";"Posteggio isolato";"lun. mar. mer. gio. ven. sab. dom.";"Settimanale";"Stagionale";"0";"0";"0";"0";"0";"0";"1";"0";"0";"1";"1";"Asti";""
"2014";" 005028 ";"CASTELLO DI ANNONE";"FRAZ. MONFALLITO";"Mercato";"ven.";"Settimanale";"Annuale";"0";"1";"0";"1";"2";"0";"0";"0";"0";"0";"2";"Asti";""
"2014";" 005053 ";"FERRERE";"PIAZZA S.AGOSTINO";"Mercato";"mer. dom.";"Settimanale";"Annuale";"0";"2";"3";"2";"7";"0";"2";"0";"1";"3";"10";"Asti";""
"2014";" 005065 ";"MOMBARUZZO";"PIAZZA MARCONI";"Mercato";"gio.";"Settimanale";"Annuale";"0";"0";"0";"0";"0";"0";"3";"3";"2";"8";"8";"Asti";""
"2014";" 005080 ";"NIZZA MONFERRATO";"PIAZZA GARIBALDI (AREA EXTRAMERCATALE)";"Mercato";"ven.";"Settimanale";"Stagionale";"0";"0";"0";"4";"4";"0";"0";"0";"6";"6";"10";"Asti";""
"2014";" 005087 ";"PORTACOMARO";"piazza camia";"Mercato";"dom.";"Settimanale";"Annuale";"5";"0";"0";"0";"5";"5";"0";"0";"0";"5";"10";"Asti";""
"2014";" 005108 ";"TIGLIOLE";"PIAZZA REGINA MARGHERITA";"Mercato";"ven.";"Settimanale";"Annuale";"0";"4";"1";"0";"5";"0";"0";"0";"0";"0";"5";"Asti";""
"2014";" 006003 ";"ALESSANDRIA";"PIAZZA BARRERA - SPINETTA MARENGO";"Mercato";"ven.";"Settimanale";"Annuale";"0";"9";"16";"1";"26";"0";"1";"0";"0";"1";"27";"Alessandria";""
"2014";" 004078 ";"CUNEO";"DONATELLO";"Mercato";"mar.";"Settimanale";"Annuale";"0";"6";"2";"0";"8";"4";"0";"0";"0";"4";"12";"Cuneo";""
"2014";" 004078 ";"CUNEO";"PIAZZA VIRGINIO";"Mercato";"mar.";"Settimanale";"Annuale";"2";"5";"1";"22";"30";"0";"0";"0";"5";"5";"35";"Cuneo";""
"2014";" 004078 ";"CUNEO";"PIAZZA GALIMBERTI - VIA ROMA";"Mercato";"mar.";"Settimanale";"Annuale";"0";"0";"265";"0";"265";"0";"0";"0";"0";"0";"265";"Cuneo";""
"2014";" 004081 ";"DOGLIANI";"CIMITERO COMUNALE";"Posteggio isolato";"lun. mar. mer. gio. ven. sab. dom.";"Settimanale";"Stagionale";"0";"0";"0";"0";"0";"0";"0";"1";"0";"1";"1";"Cuneo";""
"2014";" 004100 ";"GRINZANE CAVOUR";"piazza Della Chiesa";"Mercato";"mer.";"Settimanale";"Annuale";"0";"5";"5";"0";"10";"0";"0";"1";"1";"2";"12";"Cuneo";""
"2014";" 004113 ";"MAGLIANO ALFIERI";"PIAZZA BERGAMASCO";"Mercato";"gio.";"Settimanale";"Annuale";"0";"2";"0";"0";"2";"0";"3";"4";"3";"10";"12";"Cuneo";""
"2014";" 004148 ";"NEIVE";"Piazza Garibaldi";"Mercato";"mer.";"Settimanale";"Annuale";"0";"11";"12";"2";"25";"27";"0";"2";"0";"29";"54";"Cuneo";""
"2014";" 004183 ";"ROASCHIA";"P.zza San Dalmazzo";"Posteggio isolato";"mer.";"Settimanale";"Annuale";"0";"0";"0";"0";"0";"1";"0";"0";"0";"1";"1";"Cuneo";""
"2014";" 004192 ";"ROCCAVIONE";"PIAZZA DON G. B. CHESTA";"Mercato";"sab.";"Settimanale";"Annuale";"0";"5";"1";"1";"7";"0";"3";"7";"1";"11";"18";"Cuneo";""
"2014";" 004215 ";"SAVIGLIANO";"Via Bisalta";"Posteggio isolato";"lun. mar. mer. gio. ven. sab. dom.";"Settimanale";"Annuale";"0";"1";"0";"0";"1";"0";"0";"0";"0";"0";"1";"Cuneo";""
"2014";" 004217 ";"SCARNAFIGI";"PIAZZA EUROPA E PIAZZA CASTELLO";"Mercato";"mar. mer. ven.";"Settimanale";"Annuale";"0";"4";"0";"0";"4";"0";"2";"0";"0";"2";"6";"Cuneo";""
"2014";" 004242 ";"VICOFORTE";"Loc. Santuario - P.zza C. Emanuele I";"Mercato";"gio.";"Settimanale";"Annuale";"0";"4";"4";"1";"9";"0";"2";"2";"0";"4";"13";"Cuneo";""
"2014";" 005005 ";"ASTI";"PIAZZA SAN SECONDO";"Mercato";"sab.";"Quindicinale";"Annuale";"0";"10";"10";"0";"20";"0";"0";"0";"0";"0";"20";"Asti";""
"2014";" 005017 ";"CANELLI";"PIAZZA CAVOUR";"Posteggio isolato";"mar. gio. ven. sab.";"Settimanale";"Annuale";"0";"1";"0";"0";"1";"0";"0";"0";"0";"0";"1";"Asti";""
"2014";" 005047 ";"CORTAZZONE";"Piazza Luigi Vallero";"Mercato";"mer.";"Settimanale";"Annuale";"4";"4";"0";"0";"8";"0";"0";"2";"0";"2";"10";"Asti";""
"2014";" 005080 ";"NIZZA MONFERRATO";"VIA CARLO ALBERTO (AREA MERCATALE)";"Mercato";"ven.";"Settimanale";"Annuale";"0";"0";"16";"0";"16";"0";"0";"0";"0";"0";"16";"Asti";""
"2014";" 005112 ";"VALFENERA";"PIAZZA TOMMASO VILLA N. 3";"Mercato";"sab.";"Settimanale";"Annuale";"0";"7";"5";"1";"13";"0";"0";"0";"0";"0";"13";"Asti";""
"2014";" 006003 ";"ALESSANDRIA";"PIAZZA SAN FRANCESCO - LITTA PARODI";"Mercato";"mar.";"Settimanale";"Annuale";"0";"1";"0";"0";"1";"0";"2";"0";"1";"3";"4";"Alessandria";""
"2014";" 004072 ";"CORNELIANO D'ALBA";"PIAZZA COTTOLENGO";"Mercato";"gio.";"Settimanale";"Annuale";"0";"7";"10";"0";"17";"0";"0";"0";"0";"0";"17";"Cuneo";""
"2014";" 004078 ";"CUNEO";"PIAZZA VIRGINIO";"Mercato";"ven.";"Settimanale";"Annuale";"2";"5";"1";"22";"30";"0";"0";"0";"5";"5";"35";"Cuneo";""
"2014";" 004086 ";"FARIGLIANO";"P.ZZA SAN GIOVANNI";"Mercato";"dom.";"Settimanale";"Annuale";"0";"2";"3";"0";"5";"0";"2";"1";"3";"6";"11";"Cuneo";""
"2014";" 004089 ";"FOSSANO";"Piazza Santa Maria del Salice";"Posteggio isolato";"lun. mar. mer. gio. ven. sab. dom.";"Settimanale";"Stagionale";"0";"0";"0";"0";"0";"0";"1";"0";"0";"1";"1";"Cuneo";""
"2014";" 004089 ";"FOSSANO";"Piazza Dompe'";"Posteggio isolato";"lun. mar. mer. gio. ven. sab. dom.";"Settimanale";"Stagionale";"0";"0";"0";"0";"0";"0";"1";"0";"0";"1";"1";"Cuneo";""
"2014";" 004099 ";"GOVONE";"PIAZZA SS ANNUNZIATA";"Mercato";"gio.";"Settimanale";"Annuale";"0";"2";"5";"0";"7";"0";"0";"0";"0";"0";"7";"Cuneo";""
"2014";" 004165 ";"PIANFEI";"PIAZZA VITTORIO EMANUELE";"Mercato";"dom.";"Settimanale";"Annuale";"0";"2";"2";"1";"5";"0";"0";"0";"0";"0";"5";"Cuneo";""
"2014";" 004209 ";"SANFRONT";"P.ZZA STATUTO - P.ZZA IV NOVEMBRE - VIA MAZZINI";"Mercato";"lun.";"Settimanale";"Annuale";"1";"12";"26";"7";"46";"1";"2";"6";"4";"13";"59";"Cuneo";""
"2014";" 004240 ";"VERZUOLO";"Piazza Martiri Liberazione - Vicolo Fucina";"Mercato";"mar.";"Settimanale";"Annuale";"1";"13";"25";"5";"44";"0";"1";"15";"0";"16";"60";"Cuneo";""
"2014";" 005005 ";"ASTI";"Piazza N.S. Lourdes";"Mercato";"lun. gio.";"Settimanale";"Annuale";"0";"6";"1";"5";"12";"0";"0";"0";"0";"0";"12";"Asti";""
"2014";" 005014 ";"CALLIANO";"LOCALITA' PIRENTA";"Posteggio isolato";"lun. mar. mer. gio. ven. sab.";"Settimanale";"Annuale";"0";"0";"0";"0";"0";"1";"0";"0";"0";"1";"1";"Asti";""
"2014";" 005017 ";"CANELLI";"PIAZZA GANCIA, PIAZZA CAVOUR E PIAZZA ZOPPA";"Mercato";"mar.";"Settimanale";"Annuale";"1";"18";"44";"6";"69";"0";"1";"4";"2";"7";"76";"Asti";""
"2014";" 005017 ";"CANELLI";"PIAZZA GANCIA, PIAZZA CAVOUR, PIAZZA ZOPPA E VIALE INDIPENDENZA";"Mercato";"ven.";"Settimanale";"Annuale";"0";"11";"30";"7";"48";"0";"1";"9";"3";"13";"61";"Asti";""
"2014";" 005076 ";"MONTEGROSSO D'ASTI";"PIAZZA SARACCO E PIAZZA ROERO";"Mercato";"mar.";"Settimanale";"Annuale";"0";"9";"9";"2";"20";"0";"2";"9";"4";"15";"35";"Asti";""
"2014";" 006001 ";"ACQUI TERME";"PIAZZA ORTO SAN PIETRO";"Mercato";"ven.";"Settimanale";"Annuale";"0";"16";"4";"0";"20";"0";"7";"0";"0";"7";"27";"Alessandria";""
"2014";" 004066 ";"CEVA";"VIA MARENCO, P.ZZA VITT. EM.II, P.ZZA GANDOLFI, P.ZZA V.VENETO, C.SO GARIBALDI";"Mercato";"mer.";"Settimanale";"Annuale";"0";"17";"73";"5";"95";"12";"3";"18";"2";"35";"130";"Cuneo";""
"2014";" 004082 ";"DRONERO";"Piazza XX settembre";"Mercato";"mer. gio. ven. sab.";"Settimanale";"Annuale";"2";"2";"0";"0";"4";"0";"0";"0";"0";"0";"4";"Cuneo";""
"2014";" 004089 ";"FOSSANO";"Piazza Battuti Rossi";"Posteggio isolato";"lun. mar. mer. gio. ven. sab. dom.";"Settimanale";"Stagionale";"0";"0";"0";"0";"0";"0";"1";"0";"0";"1";"1";"Cuneo";""
"2014";" 004130 ";"MONDOVI'";"PIAZZA SANTA MARIA MAGGIORE";"Posteggio isolato";"gio.";"Settimanale";"Annuale";"0";"1";"0";"0";"1";"0";"0";"0";"0";"0";"1";"Cuneo";""
"2014";" 004133 ";"MONTA'";"PIAZZA VITTORIO VENETO";"Mercato";"dom.";"Settimanale";"Annuale";"0";"10";"35";"0";"45";"0";"1";"0";"8";"9";"54";"Cuneo";""
"2014";" 004150 ";"NIELLA BELBO";"Piazza Mercato - Corso P.Piemonte/ PIAZZA G. GIORDANO";"Mercato";"gio.";"Settimanale";"Annuale";"0";"4";"9";"0";"13";"0";"0";"4";"1";"5";"18";"Cuneo";""
"2014";" 004158 ";"PAGNO";"Piazza Mercato";"Mercato";"sab.";"Settimanale";"Annuale";"0";"3";"1";"0";"4";"0";"0";"2";"0";"2";"6";"Cuneo";""
"2014";" 004175 ";"PRIERO";"PIAZZA VITTORIO EMANUELE IIï¾°";"Mercato";"dom.";"Settimanale";"Annuale";"0";"2";"6";"0";"8";"0";"0";"0";"2";"2";"10";"Cuneo";""
"2014";" 004176 ";"PRIOCCA";"piazza Roma";"Mercato";"dom.";"Settimanale";"Annuale";"0";"2";"3";"2";"7";"0";"1";"0";"1";"2";"9";"Cuneo";""
"2014";" 004191 ";"ROCCASPARVERA";"PIAZZALE FRAZIONE PIANO QUINTO - ROCCASPARVERA";"Mercato";"lun. ven. dom.";"Settimanale";"Stagionale";"3";"0";"0";"3";"6";"0";"0";"0";"0";"0";"6";"Cuneo";""
"2014";" 004222 ";"SOMMARIVA DEL BOSCO";"PIAZZA ROMA";"Mercato";"sab.";"Settimanale";"Annuale";"0";"2";"2";"0";"4";"0";"0";"0";"0";"0";"4";"Cuneo";""
"2014";" 004248 ";"VINADIO";"Piazza Umberto I";"Mercato";"mer.";"Settimanale";"Stagionale";"0";"6";"20";"3";"29";"0";"0";"1";"0";"1";"30";"Cuneo";""
"2014";" 005073 ";"MONTAFIA";"PIAZZA CAMILLO RICCIO";"Mercato";"lun.";"Settimanale";"Annuale";"0";"3";"7";"1";"11";"0";"0";"2";"1";"3";"14";"Asti";""
"2014";" 005097 ";"SAN DAMIANO D'ASTI";"PIAZZA 1275";"Mercato";"dom.";"Settimanale";"Annuale";"0";"2";"0";"0";"2";"0";"2";"0";"0";"2";"4";"Asti";""
"2014";" 006003 ";"ALESSANDRIA";"PORTICI PIAZZA GARIBALDI, PIAZZA MARCONI, PORTICI CORSO ROMA";"Mercato";"dom.";"Quindicinale";"Annuale";"0";"0";"70";"0";"70";"0";"0";"0";"0";"0";"70";"Alessandria";""
"2014";" 004064 ";"CERVASCA";"CERVASCA - PIAZZA DOTT. BERNARDI";"Mercato";"sab.";"Settimanale";"Annuale";"0";"4";"4";"1";"9";"0";"0";"0";"0";"0";"9";"Cuneo";""
"2014";" 004078 ";"CUNEO";"CERIALDO - SAN PIO";"Mercato";"sab.";"Settimanale";"Annuale";"0";"3";"0";"0";"3";"0";"0";"0";"0";"0";"3";"Cuneo";""
"2014";" 004079 ";"DEMONTE";"PIAZZA RENZO SPADA";"Mercato";"gio.";"Settimanale";"Annuale";"25";"0";"0";"6";"31";"1";"0";"0";"0";"1";"32";"Cuneo";""
"2014";" 004082 ";"DRONERO";"Piazza Martiri della Liberta'";"Mercato";"lun.";"Settimanale";"Annuale";"1";"16";"67";"7";"91";"0";"0";"0";"0";"0";"91";"Cuneo";""
"2014";" 004183 ";"ROASCHIA";"P.zza San Dalmazzo";"Posteggio isolato";"mer.";"Settimanale";"Annuale";"0";"0";"0";"0";"0";"1";"0";"0";"0";"1";"1";"Cuneo";""
"2014";" 004219 ";"SERRAVALLE LANGHE";"PIAZZA RAVINA";"Mercato";"gio.";"Settimanale";"Annuale";"0";"2";"4";"3";"9";"0";"3";"0";"0";"3";"12";"Cuneo";""
"2014";" 004225 ";"TARANTASCA";"PIAZZA G. MARCONI";"Mercato";"gio.";"Settimanale";"Annuale";"0";"3";"0";"0";"3";"0";"0";"3";"0";"3";"6";"Cuneo";""
"2014";" 004245 ";"VILLANOVA MONDOVI'";"PIAZZA FILIPPI";"Mercato";"gio.";"Settimanale";"Annuale";"16";"10";"1";"5";"32";"0";"0";"0";"0";"0";"32";"Cuneo";""
"2014";" 005005 ";"ASTI";"Piazza Campo del Palio";"Mercato";"lun. mar. gio. ven.";"Settimanale";"Annuale";"0";"4";"0";"0";"4";"0";"2";"0";"0";"2";"6";"Asti";""
"2014";" 005065 ";"MOMBARUZZO";"VIA STAZIONE";"Mercato";"sab.";"Settimanale";"Annuale";"0";"2";"0";"0";"2";"0";"3";"6";"3";"12";"14";"Asti";""
"2014";" 005069 ";"MONCALVO";"PIAZZA CARLO ALBERTO";"Mercato";"gio.";"Settimanale";"Annuale";"0";"25";"55";"8";"88";"0";"0";"0";"0";"0";"88";"Asti";""
"2014";" 005080 ";"NIZZA MONFERRATO";"P.ZZA XX SETTEMBRE (AREA EXTRAMERCATALE)";"Mercato";"mer. ven. dom.";"Settimanale";"Annuale";"0";"0";"0";"14";"14";"0";"0";"0";"2";"2";"16";"Asti";""
"2014";" 005097 ";"SAN DAMIANO D'ASTI";"PIAZZA CAMISOLA";"Mercato";"mer. ven. dom.";"Settimanale";"Annuale";"0";"0";"0";"10";"10";"0";"0";"0";"0";"0";"10";"Asti";""
"2014";" 005097 ";"SAN DAMIANO D'ASTI";"PIAZZA 1275";"Mercato";"ven.";"Settimanale";"Annuale";"0";"6";"0";"0";"6";"0";"0";"0";"0";"0";"6";"Asti";""
"2014";" 006001 ";"ACQUI TERME";"PIAZZA ADDOLORATA - VIA GARIBALDI";"Mercato";"ven.";"Settimanale";"Annuale";"0";"0";"48";"0";"48";"0";"0";"2";"0";"2";"50";"Alessandria";""
"2014";" 006003 ";"ALESSANDRIA";"CORSO MONFERATO";"Mercato";"lun. mer. sab.";"Settimanale";"Annuale";"0";"1";"0";"0";"1";"0";"2";"0";"0";"2";"3";"Alessandria";""
"2014";" 004078 ";"CUNEO";"CERIALDO - SAN PIO";"Posteggio isolato";"mer.";"Settimanale";"Annuale";"0";"1";"0";"0";"1";"0";"0";"0";"0";"0";"1";"Cuneo";""
"2014";" 004078 ";"CUNEO";"PIAZZA EUROPA";"Mercato";"sab.";"Settimanale";"Annuale";"0";"0";"43";"0";"43";"0";"0";"0";"0";"0";"43";"Cuneo";""
"2014";" 004089 ";"FOSSANO";"Largo Eroi";"Posteggio isolato";"lun. mar. mer. gio. ven. sab. dom.";"Settimanale";"Stagionale";"0";"0";"0";"0";"0";"0";"1";"0";"0";"1";"1";"Cuneo";""
"2014";" 004089 ";"FOSSANO";"Piazza Card. Michele Pellegrino";"Posteggio isolato";"lun. mar. mer. gio. ven. sab. dom.";"Settimanale";"Stagionale";"0";"0";"0";"0";"0";"0";"1";"0";"0";"1";"1";"Cuneo";""
"2014";" 004117 ";"MARENE";"piazza Carignano";"Mercato";"mer.";"Settimanale";"Annuale";"0";"5";"2";"0";"7";"0";"0";"7";"0";"7";"14";"Cuneo";""
"2014";" 004130 ";"MONDOVI'";"CORSO EUROPA";"Posteggio isolato";"mer.";"Settimanale";"Annuale";"0";"1";"0";"0";"1";"0";"0";"0";"0";"0";"1";"Cuneo";""
"2014";" 004133 ";"MONTA'";"PIAZZA SAN MICHELE";"Mercato";"gio.";"Settimanale";"Annuale";"0";"6";"15";"0";"21";"0";"0";"0";"4";"4";"25";"Cuneo";""
"2014";" 004142 ";"MONTICELLO D'ALBA";"PIAZZA MARTIRI DELLA LIBERTA'";"Mercato";"mer.";"Settimanale";"Annuale";"0";"4";"1";"0";"5";"0";"1";"3";"4";"8";"13";"Cuneo";""
"2014";" 004151 ";"NIELLA TANARO";"PIAZZA O.GIONDO";"Mercato";"dom.";"Settimanale";"Annuale";"8";"0";"0";"0";"8";"0";"0";"0";"0";"0";"8";"Cuneo";""
"2014";" 004170 ";"POCAPAGLIA";"Frazione Macellai";"Mercato";"lun.";"Settimanale";"Annuale";"0";"5";"3";"0";"8";"0";"0";"0";"0";"0";"8";"Cuneo";""
"2014";" 004171 ";"POLONGHERA";"PIAZZA VITTORIO VENETO";"Mercato";"ven.";"Settimanale";"Annuale";"0";"2";"1";"0";"3";"1";"1";"2";"1";"5";"8";"Cuneo";""
"2014";" 004178 ";"PRUNETTO";"Via Romavecchia";"Mercato";"lun.";"Settimanale";"Annuale";"0";"3";"0";"0";"3";"6";"3";"0";"3";"12";"15";"Cuneo";""
"2014";" 004203 ";"SALUZZO";"CORSO ITALIA, PIAZZA RISORGIMENTO";"Mercato";"mer.";"Settimanale";"Annuale";"0";"16";"63";"23";"102";"0";"6";"4";"27";"37";"139";"Cuneo";""
"2014";" 004203 ";"SALUZZO";"concentrico e via Don Soleri";"Mercato";"sab.";"Settimanale";"Annuale";"0";"40";"200";"45";"285";"0";"7";"20";"35";"62";"347";"Cuneo";""
"2014";" 004214 ";"SANTO STEFANO ROERO";"LOC. CAPOLUOGO";"Mercato";"ven.";"Settimanale";"Annuale";"0";"5";"5";"4";"14";"0";"0";"0";"0";"0";"14";"Cuneo";""
"2014";" 004237 ";"VENASCA";"Piazza martiri - Via IV Novembre- Piazza Caduti - Piazza Vineis";"Mercato";"lun.";"Settimanale";"Annuale";"0";"12";"42";"3";"57";"0";"0";"0";"0";"0";"57";"Cuneo";""
"2014";" 004250 ";"VOTTIGNASCO";"PIAZZA MARCONI";"Mercato";"mar.";"Settimanale";"Annuale";"0";"2";"0";"0";"2";"0";"0";"1";"0";"1";"3";"Cuneo";""
"2014";" 005005 ";"ASTI";"CORSO XXV APRILE";"Posteggio isolato";"lun. mar. mer. gio. ven. sab. dom.";"Settimanale";"Stagionale";"0";"0";"0";"0";"0";"0";"1";"0";"0";"1";"1";"Asti";""
"2014";" 005014 ";"CALLIANO";"FRAZ.SAN DESIDERIO-VIA VITT.EMANUELE IIï¾°";"Posteggio isolato";"lun. mar. mer. gio. ven. sab.";"Settimanale";"Annuale";"0";"0";"0";"0";"0";"1";"0";"0";"0";"1";"1";"Asti";""
"2014";" 004068 ";"CHIUSA DI PESIO";"PIAZZA VITTORIO VENETO";"Mercato";"dom.";"Settimanale";"Annuale";"2";"10";"12";"4";"28";"2";"0";"0";"0";"2";"30";"Cuneo";""
"2014";" 004089 ";"FOSSANO";"Via Roma";"Posteggio isolato";"lun. mar. mer. gio. ven. sab. dom.";"Settimanale";"Stagionale";"0";"1";"0";"0";"1";"0";"0";"0";"0";"0";"1";"Cuneo";""
"2014";" 004092 ";"FRASSINO";"VIA MATTEODO BERNARDO";"Mercato";"dom.";"Settimanale";"Stagionale";"0";"2";"3";"1";"6";"2";"0";"0";"0";"2";"8";"Cuneo";""
"2014";" 004101 ";"GUARENE";"FRAZIONE VACCHERIA - P.ZZA DON MORONE";"Mercato";"dom.";"Settimanale";"Annuale";"0";"1";"1";"0";"2";"0";"4";"6";"0";"10";"12";"Cuneo";""
"2014";" 004104 ";"LAGNASCO";"piazza Umbero Iï¾°";"Posteggio isolato";"gio.";"Settimanale";"Annuale";"0";"1";"0";"0";"1";"0";"0";"0";"0";"0";"1";"Cuneo";""
"2014";" 004115 ";"MANGO";"PIAZZA XX SETTEMBRE - VIA G.MARCONI";"Mercato";"lun.";"Settimanale";"Annuale";"0";"5";"6";"4";"15";"0";"0";"1";"0";"1";"16";"Cuneo";""
"2014";" 004128 ";"MONASTEROLO DI SAVIGLIANO";"PIAZZA LIBERTA'";"Posteggio isolato";"lun. mer. gio. sab.";"Settimanale";"Annuale";"0";"1";"0";"0";"1";"0";"0";"0";"0";"0";"1";"Cuneo";""
"2014";" 004130 ";"MONDOVI'";"PIAZZA ELLERO";"Mercato";"mar.";"Settimanale";"Annuale";"0";"15";"49";"27";"91";"0";"5";"9";"14";"28";"119";"Cuneo";""
"2014";" 004130 ";"MONDOVI'";"PIAZZA MONTEREGALE";"Mercato";"mer.";"Settimanale";"Annuale";"0";"6";"12";"9";"27";"0";"1";"2";"0";"3";"30";"Cuneo";""
"2014";" 004140 ";"MONTEU ROERO";"PIAZZA ROBERTO BERGADANI";"Mercato";"mer.";"Settimanale";"Annuale";"0";"5";"5";"4";"14";"0";"0";"0";"0";"0";"14";"Cuneo";""
"2014";" 004145 ";"MURAZZANO";"PIAZZA CERRINA - PIAZZA UMBERTO I";"Mercato";"ven.";"Settimanale";"Annuale";"0";"6";"6";"2";"14";"13";"0";"0";"4";"17";"31";"Cuneo";""
"2014";" 004183 ";"ROASCHIA";"P.zza San Dalmazzo";"Posteggio isolato";"mer.";"Settimanale";"Annuale";"0";"0";"0";"0";"0";"0";"0";"0";"1";"1";"1";"Cuneo";""
"2014";" 004186 ";"ROBURENT";"VIA ODASSI";"Mercato";"ven.";"Settimanale";"Stagionale";"0";"6";"39";"2";"47";"0";"0";"0";"0";"0";"47";"Cuneo";""
"2014";" 004201 ";"SALICETO";"PIAZZA CARLO GIUSTA";"Mercato";"ven.";"Settimanale";"Annuale";"0";"5";"7";"2";"14";"0";"1";"3";"0";"4";"18";"Cuneo";""
"2014";" 004233 ";"VALDIERI";"LOCALITA' TERME DI VALDIERI";"Mercato";"sab. dom.";"Settimanale";"Stagionale";"0";"0";"0";"0";"0";"0";"1";"5";"1";"7";"7";"Cuneo";""
"2014";" 005005 ";"ASTI";"CORSO CASALE LOCALITA' VALGERA";"Posteggio isolato";"lun. mar. mer. gio. ven. sab. dom.";"Settimanale";"Stagionale";"0";"0";"0";"1";"1";"0";"0";"0";"0";"0";"1";"Asti";""
"2014";" 005014 ";"CALLIANO";"FRAZ. PERRONA";"Posteggio isolato";"lun. mar. mer. gio. ven. sab.";"Settimanale";"Annuale";"0";"0";"0";"0";"0";"1";"0";"0";"0";"1";"1";"Asti";""
"2014";" 005117 ";"VILLAFRANCA D'ASTI";"PIAZZA MARCONI E PIAZZA DELLE POLLAIE";"Mercato";"mar.";"Settimanale";"Annuale";"0";"17";"16";"3";"36";"0";"0";"7";"1";"8";"44";"Asti";""
"2014";" 006003 ";"ALESSANDRIA";"PIAZZETTA DELLA LEGA";"Mercato";"sab.";"Quindicinale";"Annuale";"0";"0";"0";"15";"15";"0";"0";"0";"0";"0";"15";"Alessandria";""
"2014";" 004066 ";"CEVA";"PIAZZA GANDOLFI";"Mercato";"ven.";"Settimanale";"Annuale";"0";"1";"0";"0";"1";"0";"1";"0";"0";"1";"2";"Cuneo";""
"2014";" 004073 ";"CORTEMILIA";"BORGO SAN MICHELE - BORGO SAN PANTALEO";"Mercato";"ven.";"Settimanale";"Annuale";"15";"5";"3";"4";"27";"16";"2";"2";"0";"20";"47";"Cuneo";""
"2014";" 004078 ";"CUNEO";"PIAZZA SEMINARIO";"Mercato";"mar.";"Settimanale";"Annuale";"0";"56";"81";"0";"137";"0";"20";"6";"0";"26";"163";"Cuneo";""
"2014";" 004081 ";"DOGLIANI";"P.ZZA CONFRATERNITA/VIA CORTE/P.ZZA CARLO ALBERTO/VIA VITTORIO EMANUELE/P.ZZA TOMATIS/P.ZZA UMBERTO I";"Mercato";"mar.";"Settimanale";"Annuale";"0";"15";"54";"6";"75";"0";"2";"5";"0";"7";"82";"Cuneo";""
"2014";" 004094 ";"GAMBASCA";"PIAZZA GAUTHIER";"Mercato";"dom.";"Settimanale";"Annuale";"0";"3";"4";"1";"8";"0";"0";"1";"0";"1";"9";"Cuneo";""
"2014";" 004104 ";"LAGNASCO";"PIAZZA UMBERTO I";"Mercato";"sab.";"Settimanale";"Annuale";"0";"2";"0";"0";"2";"0";"2";"0";"0";"2";"4";"Cuneo";""
"2014";" 004147 ";"NARZOLE";"Piazza Vitt.Emanuele II - Via Cavour";"Mercato";"dom.";"Settimanale";"Annuale";"4";"7";"19";"1";"31";"0";"0";"3";"1";"4";"35";"Cuneo";""
"2014";" 004155 ";"ORMEA";"Piazza San Martino";"Mercato";"mar.";"Settimanale";"Annuale";"0";"5";"2";"1";"8";"0";"2";"5";"1";"8";"16";"Cuneo";""
"2014";" 004203 ";"SALUZZO";"PIAZZA RISORGIMENTO";"Mercato";"lun. mar. mer. gio. ven. sab.";"Settimanale";"Annuale";"0";"2";"0";"2";"4";"0";"0";"0";"6";"6";"10";"Cuneo";""
"2014";" 004215 ";"SAVIGLIANO";"Piazze del Popolo, Santarosa, Cavour";"Mercato";"ven.";"Settimanale";"Annuale";"0";"24";"70";"23";"117";"0";"1";"2";"0";"3";"120";"Cuneo";""
"2014";" 004222 ";"SOMMARIVA DEL BOSCO";"VIA CAVOUR , VIALE SCUOLE";"Mercato";"mar.";"Settimanale";"Annuale";"0";"12";"20";"0";"32";"0";"1";"12";"2";"15";"47";"Cuneo";""
"2014";" 004232 ";"TRINITA'";"Piazza Umberto I";"Mercato";"gio.";"Settimanale";"Annuale";"0";"2";"0";"0";"2";"0";"3";"7";"2";"12";"14";"Cuneo";""
"2014";" 004236 ";"VALMALA";"PIAZZA COMUNALE- BORGATA CHIESA";"Mercato";"mer.";"Settimanale";"Annuale";"0";"2";"2";"1";"5";"0";"0";"0";"0";"0";"5";"Cuneo";""
"2014";" 004244 ";"VILLAFALLETTO";"VIA VITT. VENETO, P.ZZA MAZZINI, C.SO SACCO E VANZETTI";"Mercato";"gio.";"Settimanale";"Annuale";"3";"17";"38";"3";"61";"0";"1";"6";"0";"7";"68";"Cuneo";""
"2014";" 005001 ";"AGLIANO TERME";"PIAZZA ROMA";"Mercato";"gio.";"Settimanale";"Annuale";"0";"3";"0";"2";"5";"7";"0";"0";"3";"10";"15";"Asti";""
"2014";" 005005 ";"ASTI";"CORSO CASALE";"Posteggio isolato";"lun. mar. mer. gio. ven. sab. dom.";"Settimanale";"Stagionale";"0";"0";"0";"1";"1";"0";"0";"0";"0";"0";"1";"Asti";""
"2014";" 005023 ";"CASTAGNOLE MONFERRATO";"PIAZZA STATUTO";"Mercato";"mar.";"Settimanale";"Annuale";"0";"2";"2";"0";"4";"0";"2";"2";"0";"4";"8";"Asti";""
"2014";" 005077 ";"MONTEMAGNO";"PIAZZA UMBERTO I";"Mercato";"sab.";"Settimanale";"Annuale";"0";"6";"7";"1";"14";"0";"0";"0";"0";"0";"14";"Asti";""
"2014";" 005080 ";"NIZZA MONFERRATO";"P.ZZA XX SETTEMBRE (AREA MERCATALE)";"Mercato";"ven.";"Settimanale";"Annuale";"0";"15";"3";"0";"18";"0";"9";"0";"1";"10";"28";"Asti";""
"2014";" 006001 ";"ACQUI TERME";"PIAZZA ADDOLORATA - VIA GARIBALDI";"Mercato";"mar.";"Settimanale";"Annuale";"0";"0";"49";"0";"49";"0";"0";"1";"0";"1";"50";"Alessandria";""
"2014";" 006003 ";"ALESSANDRIA";"PIAZZA GARIBALDI";"Mercato";"gio.";"Settimanale";"Annuale";"0";"0";"84";"0";"84";"0";"0";"6";"0";"6";"90";"Alessandria";""
"2014";" 004075 ";"COSTIGLIOLE SALUZZO";"Piazza Vittorio Emanuele II";"Mercato";"sab.";"Settimanale";"Annuale";"0";"7";"7";"1";"15";"0";"3";"6";"0";"9";"24";"Cuneo";""
"2014";" 004077 ";"CRISSOLO";"via Umberto I, piazza duca degli Abruzzi, piazza Umberto I";"Mercato";"gio.";"Settimanale";"Stagionale";"0";"6";"18";"3";"27";"3";"0";"0";"0";"3";"30";"Cuneo";""
"2014";" 004089 ";"FOSSANO";"Piazza Diaz";"Mercato";"lun. mar. mer. gio. ven. sab. dom.";"Settimanale";"Stagionale";"0";"0";"0";"0";"0";"0";"0";"0";"10";"10";"10";"Cuneo";""
"2014";" 004126 ";"MONASTERO DI VASCO";"VIA VARIANTE";"Mercato";"lun.";"Settimanale";"Annuale";"0";"0";"2";"4";"6";"0";"0";"0";"0";"0";"6";"Cuneo";""
"2014";" 004166 ";"PIASCO";"PIAZZA BIANDRATE DI S. GIORGIO";"Mercato";"ven.";"Settimanale";"Annuale";"0";"8";"6";"1";"15";"9";"0";"0";"1";"10";"25";"Cuneo";""
"2014";" 004180 ";"REVELLO";"Piazza Denina, Piazza della Vittoria e Via G. Giolitti";"Mercato";"mer.";"Settimanale";"Annuale";"0";"12";"14";"2";"28";"0";"2";"6";"9";"17";"45";"Cuneo";""
"2014";" 004183 ";"ROASCHIA";"P.zza San Dalmazzo";"Posteggio isolato";"mer.";"Settimanale";"Annuale";"0";"0";"0";"0";"0";"1";"0";"0";"0";"1";"1";"Cuneo";""
"2014";" 004183 ";"ROASCHIA";"Fraz. Tetto Chiotti";"Posteggio isolato";"mer.";"Settimanale";"Stagionale";"0";"0";"0";"0";"0";"1";"0";"0";"0";"1";"1";"Cuneo";""
"2014";" 004189 ";"ROCCA DE' BALDI";"Piazza Roma";"Mercato";"gio.";"Settimanale";"Annuale";"0";"3";"5";"3";"11";"0";"1";"1";"0";"2";"13";"Cuneo";""
"2014";" 004208 ";"SANFRE'";"PIAZZA DE ZARDO";"Mercato";"gio.";"Settimanale";"Annuale";"0";"4";"5";"0";"9";"0";"0";"0";"0";"0";"9";"Cuneo";""
"2014";" 004212 ";"SANTA VITTORIA D'ALBA";"PIAZZA EUROPA - FRAZIONE CINZANO";"Mercato";"mar.";"Settimanale";"Annuale";"1";"4";"3";"0";"8";"0";"3";"10";"2";"15";"23";"Cuneo";""
"2014";" 004233 ";"VALDIERI";"PIAZZA REGINA ELENA - VALDIERI CAPOLUOGO";"Mercato";"gio.";"Settimanale";"Annuale";"0";"4";"1";"0";"5";"0";"1";"4";"2";"7";"12";"Cuneo";""
"2014";" 005005 ";"ASTI";"C.SO ALESSANDRIA ANGOLO VIA DEL LAVORO";"Posteggio isolato";"lun. mar. mer. gio. ven. sab. dom.";"Settimanale";"Stagionale";"0";"0";"0";"1";"1";"0";"0";"0";"0";"0";"1";"Asti";""
"2014";" 005012 ";"BUTTIGLIERA D'ASTI";"Piazza Baruffaldi";"Mercato";"dom.";"Settimanale";"Annuale";"0";"5";"20";"2";"27";"0";"1";"3";"3";"7";"34";"Asti";""
"2014";" 005014 ";"CALLIANO";"VIA CAVOUR";"Posteggio isolato";"mar. mer. gio. ven. sab.";"Settimanale";"Annuale";"0";"0";"0";"0";"0";"1";"0";"0";"0";"1";"1";"Asti";""
"2014";" 005071 ";"MONGARDINO";"PIAZZA IV NOVEMBRE";"Mercato";"mar.";"Settimanale";"Annuale";"0";"2";"0";"0";"2";"0";"0";"0";"0";"0";"2";"Asti";""
"2014";" 006001 ";"ACQUI TERME";"PIAZZA MAGGIORINO FERRARIS";"Mercato";"ven.";"Settimanale";"Annuale";"0";"4";"3";"0";"7";"0";"7";"9";"0";"16";"23";"Alessandria";""
"2014";" 006003 ";"ALESSANDRIA";"PIAZZA DOSSENA - VALLE SAN BARTOLOMEO";"Mercato";"mer. sab.";"Settimanale";"Annuale";"0";"2";"0";"0";"2";"0";"0";"1";"0";"1";"3";"Alessandria";""
"2014";" 004116 ";"MANTA";"Piazza del popolo";"Mercato";"gio.";"Settimanale";"Annuale";"0";"4";"4";"0";"8";"0";"2";"7";"0";"9";"17";"Cuneo";""
"2014";" 004131 ";"MONESIGLIO";"piazza xx settembre";"Mercato";"mar.";"Settimanale";"Annuale";"0";"5";"8";"0";"13";"6";"0";"0";"0";"6";"19";"Cuneo";""
"2014";" 004134 ";"MONTALDO DI MONDOVI'";"Fraz. Sant Anna Collarea";"Mercato";"lun.";"Settimanale";"Stagionale";"0";"0";"0";"0";"0";"8";"5";"8";"4";"25";"25";"Cuneo";""
"2014";" 004139 ";"MONTEROSSO GRANA";"FRAZIONE SAN PIETRO";"Posteggio isolato";"lun.";"Settimanale";"Annuale";"0";"1";"0";"0";"1";"0";"0";"0";"0";"0";"1";"Cuneo";""
"2014";" 004157 ";"PAESANA";"Piazza Statuto - Piazza Vittorio Veneto - Piazza Reinaud";"Mercato";"ven.";"Settimanale";"Annuale";"0";"14";"31";"7";"52";"0";"1";"2";"3";"6";"58";"Cuneo";""
"2014";" 004159 ";"PAMPARATO";"PIAZZA MARCONI";"Mercato";"dom.";"Settimanale";"Stagionale";"0";"0";"3";"0";"3";"0";"0";"0";"0";"0";"3";"Cuneo";""
"2014";" 004176 ";"PRIOCCA";"via Roma";"Mercato";"gio.";"Settimanale";"Annuale";"0";"2";"1";"0";"3";"1";"2";"2";"3";"8";"11";"Cuneo";""
"2014";" 004215 ";"SAVIGLIANO";"Piazza Del Popolo- Santarosa-Cavour";"Mercato";"mar.";"Settimanale";"Annuale";"0";"24";"83";"23";"130";"0";"1";"2";"0";"3";"133";"Cuneo";""
"2014";" 004234 ";"VALGRANA";"P.za Duccio Galimberti";"Mercato";"gio.";"Settimanale";"Annuale";"0";"3";"3";"0";"6";"0";"0";"0";"4";"4";"10";"Cuneo";""
"2014";" 004237 ";"VENASCA";"PIAZZA MARTIRI";"Posteggio isolato";"sab.";"Settimanale";"Annuale";"0";"1";"0";"0";"1";"0";"0";"0";"0";"0";"1";"Cuneo";""
"2014";" 005005 ";"ASTI";"PIAZZA I MAGGIO";"Posteggio isolato";"lun. mar. mer. gio. ven. sab. dom.";"Settimanale";"Stagionale";"0";"0";"0";"0";"0";"0";"1";"0";"0";"1";"1";"Asti";""
"2014";" 005028 ";"CASTELLO DI ANNONE";"frazione poggio";"Posteggio isolato";"gio.";"Settimanale";"Annuale";"0";"1";"0";"0";"1";"0";"0";"0";"0";"0";"1";"Asti";""
"2014";" 005050 ";"COSTIGLIOLE D'ASTI";"PIAZZA MEDICI";"Mercato";"dom.";"Settimanale";"Annuale";"0";"7";"14";"5";"26";"0";"0";"1";"3";"4";"30";"Asti";""
"2014";" 005068 ";"MONASTERO BORMIDA";"piazza mercato - piazza castello - Piazza Diaz - Piazza Roma";"Mercato";"gio.";"Settimanale";"Annuale";"0";"5";"7";"0";"12";"6";"3";"0";"6";"15";"27";"Asti";""
"2014";" 005094 ";"ROCCAVERANO";"PIAZZA BARBERO - VIA BRUNO";"Mercato";"lun.";"Settimanale";"Annuale";"0";"1";"1";"1";"3";"0";"1";"1";"1";"3";"6";"Asti";""
"2014";" 004086 ";"FARIGLIANO";"Piazza Vittorio Emanuele II - Piazza San Giovanni";"Mercato";"ven.";"Settimanale";"Stagionale";"0";"3";"29";"2";"34";"0";"1";"10";"1";"12";"46";"Cuneo";""
"2014";" 004089 ";"FOSSANO";"Frazione Cussanio";"Mercato";"lun. mar. mer. gio. ven. sab. dom.";"Settimanale";"Stagionale";"0";"0";"0";"0";"0";"0";"0";"2";"0";"2";"2";"Cuneo";""
"2014";" 004144 ";"MOROZZO";"Piazza Carlo Barbero";"Mercato";"lun.";"Settimanale";"Annuale";"0";"7";"16";"1";"24";"0";"3";"7";"2";"12";"36";"Cuneo";""
"2014";" 004173 ";"PRADLEVES";"PIAZZALE CAMPO SPORTIVO";"Mercato";"gio.";"Settimanale";"Annuale";"3";"1";"1";"1";"6";"2";"2";"1";"1";"6";"12";"Cuneo";""
"2014";" 004190 ";"ROCCAFORTE MONDOVI'";"Roccaforte Mondovl";"Mercato";"ven.";"Settimanale";"Annuale";"0";"3";"2";"1";"6";"0";"4";"7";"4";"15";"21";"Cuneo";""
"2014";" 004203 ";"SALUZZO";"PIAZZA RISORGIMENTO";"Mercato";"ven.";"Settimanale";"Annuale";"0";"1";"0";"0";"1";"0";"1";"0";"0";"1";"2";"Cuneo";""
"2014";" 004233 ";"VALDIERI";"PIAZZA REGINA ELENA - VALDIERI CAPOLUOGO";"Mercato";"gio.";"Settimanale";"Stagionale";"0";"0";"0";"0";"0";"0";"0";"9";"0";"9";"9";"Cuneo";""
"2014";" 004233 ";"VALDIERI";"FRAZIONE SANT'ANNA DI VALDIERI";"Mercato";"sab. dom.";"Settimanale";"Stagionale";"0";"0";"0";"0";"0";"0";"0";"3";"0";"3";"3";"Cuneo";""
"2014";" 004239 ";"VERNANTE";"PIAZZA VERMENAGNA";"Mercato";"ven.";"Settimanale";"Annuale";"0";"5";"3";"0";"8";"0";"2";"3";"3";"8";"16";"Cuneo";""
"2014";" 004248 ";"VINADIO";"Piazza Umberto I";"Mercato";"mer.";"Settimanale";"Stagionale";"0";"4";"5";"1";"10";"0";"0";"0";"1";"1";"11";"Cuneo";""
"2014";" 005005 ";"ASTI";"C.so Alba - Piazza Doglio Lorenzo";"Mercato";"lun. gio.";"Settimanale";"Annuale";"0";"0";"0";"0";"0";"0";"7";"2";"7";"16";"16";"Asti";""
"2014";" 005005 ";"ASTI";"VIA TORCHIO";"Posteggio isolato";"lun. mar. mer. gio. ven. sab. dom.";"Settimanale";"Stagionale";"0";"1";"0";"0";"1";"0";"0";"0";"0";"0";"1";"Asti";""
"2014";" 005005 ";"ASTI";"Piazza Alfieri, P.zza Campo Palio, P.zza Liberta'";"Mercato";"sab.";"Settimanale";"Annuale";"0";"48";"233";"21";"302";"0";"26";"10";"0";"36";"338";"Asti";""
"2014";" 005042 ";"COCCONATO";"PIAZZA CAVOUR/ PIAZZA GIORDANO";"Mercato";"sab.";"Settimanale";"Annuale";"0";"8";"8";"1";"17";"0";"0";"0";"0";"0";"17";"Asti";""
"2014";" 006003 ";"ALESSANDRIA";"PIAZZA MARCONI";"Mercato";"lun. mar. mer. gio. ven. sab.";"Settimanale";"Annuale";"0";"11";"0";"1";"12";"0";"1";"0";"0";"1";"13";"Alessandria";""
"2014";" 004067 ";"CHERASCO";"VIA RIMEMBRANZE - FRAZ. RORETO";"Mercato";"mar.";"Settimanale";"Annuale";"0";"1";"2";"0";"3";"3";"5";"1";"0";"9";"12";"Cuneo";""
"2014";" 004071 ";"CLAVESANA";"FRAZIONE MADONNA DELLA NEVE - PIAZZA DON ROSSI";"Mercato";"dom.";"Settimanale";"Annuale";"0";"2";"1";"0";"3";"0";"0";"0";"0";"0";"3";"Cuneo";""
"2014";" 004078 ";"CUNEO";"PIAZZA SEMINARIO";"Mercato";"ven.";"Settimanale";"Annuale";"0";"50";"65";"0";"115";"0";"24";"2";"0";"26";"141";"Cuneo";""
"2014";" 004078 ";"CUNEO";"MADONNA DELL'OLMO";"Mercato";"sab.";"Settimanale";"Annuale";"0";"8";"4";"0";"12";"0";"0";"0";"0";"0";"12";"Cuneo";""
"2014";" 004084 ";"ENTRACQUE";"PIAZZA DEL MERCATO";"Mercato";"sab.";"Settimanale";"Annuale";"0";"7";"15";"5";"27";"0";"0";"0";"0";"0";"27";"Cuneo";""
"2014";" 004089 ";"FOSSANO";"Via Mondovl fronte casa anas";"Mercato";"lun. mar. mer. ven. sab. dom.";"Settimanale";"Stagionale";"0";"3";"0";"0";"3";"0";"2";"0";"0";"2";"5";"Cuneo";""
"2014";" 004089 ";"FOSSANO";"Via Cuneo";"Mercato";"ven. sab.";"Settimanale";"Stagionale";"0";"0";"0";"0";"0";"0";"2";"0";"0";"2";"2";"Cuneo";""
"2014";" 004090 ";"FRABOSA SOPRANA";"PIAZZA MARCONI-VIA DIVISIONE CUNEENSE-VIA VITTORIO EMANUELE III";"Mercato";"gio.";"Settimanale";"Stagionale";"0";"0";"7";"0";"7";"0";"9";"12";"3";"24";"31";"Cuneo";""
"2014";" 004091 ";"FRABOSA SOTTANA";"CAPOLUOGO - VIA PIAVE";"Mercato";"dom.";"Settimanale";"Stagionale";"0";"0";"6";"2";"8";"0";"2";"2";"0";"4";"12";"Cuneo";""
"2014";" 004105 ";"LA MORRA";"Piazza Vittorio Emanuele";"Mercato";"lun.";"Settimanale";"Annuale";"0";"5";"3";"0";"8";"0";"4";"4";"3";"11";"19";"Cuneo";""
"2014";" 004130 ";"MONDOVI'";"PIAZZA ELLERO";"Mercato";"sab.";"Settimanale";"Annuale";"0";"31";"135";"33";"199";"0";"4";"20";"11";"35";"234";"Cuneo";""
"2014";" 004146 ";"MURELLO";"piazza Divisione Alpina Cuneense";"Mercato";"mar.";"Settimanale";"Annuale";"0";"0";"0";"0";"0";"1";"2";"2";"0";"5";"5";"Cuneo";""
"2014";" 004223 ";"SOMMARIVA PERNO";"PIAZZA EUROPA";"Mercato";"lun.";"Settimanale";"Annuale";"0";"6";"8";"0";"14";"0";"0";"0";"2";"2";"16";"Cuneo";""
"2014";" 005005 ";"ASTI";"VIA GARIBALDI";"Posteggio isolato";"lun. mar. mer. gio. ven. sab. dom.";"Settimanale";"Stagionale";"0";"1";"0";"0";"1";"0";"0";"0";"0";"0";"1";"Asti";""
"2014";" 005030 ";"CASTELNUOVO CALCEA";"PIAZZA FONDO DEL PONTE";"Mercato";"dom.";"Settimanale";"Annuale";"0";"0";"0";"0";"0";"0";"1";"2";"0";"3";"3";"Asti";""
"2014";" 005050 ";"COSTIGLIOLE D'ASTI";"PARCO CASTELLO";"Posteggio isolato";"lun. mar. mer. gio. ven. sab. dom.";"Settimanale";"Stagionale";"0";"1";"0";"0";"1";"0";"0";"0";"0";"0";"1";"Asti";""
"2014";" 005066 ";"MOMBERCELLI";"PIAZZA UNIONE EUROPEA E PIAZZA ALFIERI";"Mercato";"lun.";"Settimanale";"Annuale";"0";"7";"11";"1";"19";"0";"3";"5";"2";"10";"29";"Asti";""
"2014";" 005089 ";"REFRANCORE";"CORSO UMBERTO I";"Mercato";"ven.";"Settimanale";"Annuale";"0";"10";"9";"1";"20";"0";"1";"1";"0";"2";"22";"Asti";""
"2014";" 005097 ";"SAN DAMIANO D'ASTI";"PIAZZA CAMISOLA";"Mercato";"lun.";"Settimanale";"Annuale";"0";"0";"23";"10";"33";"0";"0";"1";"0";"1";"34";"Asti";""
"2014";" 004163 ";"PEVERAGNO";"PIAZZA PIETRO TOSELLI - PEVERAGNO";"Mercato";"lun.";"Settimanale";"Annuale";"0";"8";"14";"3";"25";"1";"2";"5";"1";"9";"34";"Cuneo";""
"2014";" 004185 ";"ROBILANTE";"Piazza Olivero - Piazza Caduti Partigiani";"Mercato";"dom.";"Settimanale";"Annuale";"0";"7";"14";"4";"25";"0";"0";"0";"0";"0";"25";"Cuneo";""
"2014";" 004216 ";"SCAGNELLO";"LARGO GIOVANNI MURATORE";"Mercato";"dom.";"Quindicinale";"Annuale";"0";"0";"0";"20";"20";"0";"0";"0";"0";"0";"20";"Cuneo";""
"2014";" 004241 ";"VEZZA D'ALBA";"PIAZZA SAN PANCRAZIO";"Mercato";"ven.";"Settimanale";"Annuale";"0";"3";"1";"0";"4";"3";"1";"0";"3";"7";"11";"Cuneo";""
"2014";" 004249 ";"VIOLA";"Parcheggio Nuovo di Piazza Marconi";"Mercato";"lun.";"Settimanale";"Stagionale";"0";"1";"8";"1";"10";"0";"0";"2";"0";"2";"12";"Cuneo";""
"2014";" 005005 ";"ASTI";"Via Gozzano";"Mercato";"mar.";"Settimanale";"Annuale";"0";"10";"1";"18";"29";"0";"1";"0";"0";"1";"30";"Asti";""
"2014";" 005005 ";"ASTI";"CORSO SAVONA";"Posteggio isolato";"lun. mar. mer. gio. ven. sab. dom.";"Settimanale";"Stagionale";"0";"0";"0";"0";"0";"0";"1";"0";"0";"1";"1";"Asti";""
"2014";" 005014 ";"CALLIANO";"VIA ROMA";"Posteggio isolato";"mar. mer. gio. ven. sab.";"Settimanale";"Annuale";"0";"0";"0";"0";"0";"1";"0";"0";"0";"1";"1";"Asti";""
"2014";" 005014 ";"CALLIANO";"FRAZ. SAN DESIDERIO IN PROSSIMITA' DELLA CHIESA";"Posteggio isolato";"lun. mar. mer. gio. ven. sab.";"Settimanale";"Annuale";"0";"0";"0";"0";"0";"1";"0";"0";"0";"1";"1";"Asti";""
"2014";" 005031 ";"CASTELNUOVO DON BOSCO";"V. Umberto I^ - P.zza Don Bosco - V. Marconi - V. Roma - P.zza Dante - V.le Regina Margherita - V. Seglie.";"Mercato";"gio.";"Settimanale";"Annuale";"0";"12";"53";"7";"72";"0";"3";"3";"3";"9";"81";"Asti";""
"2014";" 005097 ";"SAN DAMIANO D'ASTI";"PIAZZA RINO ROSSINO";"Mercato";"lun.";"Settimanale";"Annuale";"0";"1";"0";"0";"1";"0";"2";"0";"0";"2";"3";"Asti";""
"2014";" 006001 ";"ACQUI TERME";"CORSO ITALIA - PIAZZA SAN FRANCESCO - PORTICI SARACCO";"Mercato";"ven.";"Settimanale";"Annuale";"0";"0";"41";"0";"41";"0";"0";"5";"0";"5";"46";"Alessandria";""
"2014";" 006003 ";"ALESSANDRIA";"PIAZZA GARIBALDI";"Mercato";"lun.";"Settimanale";"Annuale";"0";"0";"164";"0";"164";"0";"0";"0";"0";"0";"164";"Alessandria";""
"2014";" 004066 ";"CEVA";"PIAZZA GANDOLFI";"Mercato";"sab.";"Settimanale";"Annuale";"0";"4";"2";"0";"6";"0";"2";"3";"0";"5";"11";"Cuneo";""
"2014";" 004078 ";"CUNEO";"DONATELLO";"Mercato";"ven.";"Settimanale";"Annuale";"0";"7";"1";"0";"8";"4";"0";"0";"0";"4";"12";"Cuneo";""
"2014";" 004089 ";"FOSSANO";"Via Roma Via Cavour Piazza Castello";"Mercato";"mer.";"Settimanale";"Annuale";"0";"43";"169";"19";"231";"0";"0";"2";"15";"17";"248";"Cuneo";""
"2014";" 004159 ";"PAMPARATO";"VALCASOTTO - PIAZZA S. LIBERA";"Posteggio isolato";"dom.";"Settimanale";"Stagionale";"0";"0";"0";"1";"1";"0";"0";"0";"0";"0";"1";"Cuneo";""
"2014";" 004172 ";"PONTECHIANALE";"FR.NE MADDALENA";"Mercato";"mar.";"Settimanale";"Stagionale";"0";"25";"23";"4";"52";"0";"0";"0";"0";"0";"52";"Cuneo";""
"2014";" 004179 ";"RACCONIGI";"CENTRO STORICO";"Mercato";"sab.";"Settimanale";"Annuale";"0";"10";"37";"3";"50";"0";"2";"3";"4";"9";"59";"Cuneo";""
"2014";" 004183 ";"ROASCHIA";"P.zza San Dalmazzo";"Posteggio isolato";"mer.";"Settimanale";"Annuale";"0";"0";"0";"0";"0";"0";"0";"0";"1";"1";"1";"Cuneo";""
"2014";" 004183 ";"ROASCHIA";"Fraz. Tetto Chiotti";"Posteggio isolato";"mer.";"Settimanale";"Stagionale";"0";"0";"0";"0";"0";"0";"0";"0";"1";"1";"1";"Cuneo";""
"2014";" 004207 ";"SAN DAMIANO MACRA";"PIAZZA CADUTI";"Mercato";"dom.";"Settimanale";"Annuale";"0";"1";"0";"1";"2";"0";"2";"1";"1";"4";"6";"Cuneo";""
"2014";" 004231 ";"TREZZO TINELLA";"PIAZZA DON TERNAVASIO";"Mercato";"mar.";"Settimanale";"Annuale";"0";"4";"3";"2";"9";"0";"0";"0";"0";"0";"9";"Cuneo";""
"2014";" 005005 ";"ASTI";"Via Pavese";"Mercato";"mar. ven.";"Settimanale";"Annuale";"0";"4";"0";"3";"7";"0";"2";"1";"0";"3";"10";"Asti";""
"2014";" 005005 ";"ASTI";"PIAZZA I MAGGIO";"Posteggio isolato";"lun. mar. mer. gio. ven. sab. dom.";"Settimanale";"Stagionale";"0";"0";"0";"0";"0";"0";"1";"0";"0";"1";"1";"Asti";""
"2014";" 005013 ";"CALAMANDRANA";"PIAZZA DANTE ALIGHIERI";"Mercato";"lun.";"Settimanale";"Annuale";"0";"2";"2";"0";"4";"0";"1";"2";"1";"4";"8";"Asti";""
"2014";" 005022 ";"CASTAGNOLE DELLE LANZE";"PIAZZA S. BARTOLOMEO VIA ROMA VIA CASETTA";"Mercato";"gio.";"Settimanale";"Annuale";"0";"18";"39";"4";"61";"0";"0";"0";"0";"0";"61";"Asti";""
"2014";" 005058 ";"INCISA SCAPACCINO";"PIAZZA FERRARO";"Mercato";"mer.";"Settimanale";"Annuale";"0";"0";"0";"0";"0";"0";"3";"4";"3";"10";"10";"Asti";""
"2014";" 005066 ";"MOMBERCELLI";"PIAZZA UNIONE EUROPEA";"Posteggio isolato";"sab.";"Settimanale";"Annuale";"0";"1";"0";"0";"1";"0";"0";"0";"0";"0";"1";"Asti";""
"2014";" 005067 ";"MONALE";"PIAZZA VITTORIO EMANUELE II";"Mercato";"dom.";"Settimanale";"Annuale";"4";"4";"0";"1";"9";"4";"4";"0";"1";"9";"18";"Asti";""
"2014";" 005097 ";"SAN DAMIANO D'ASTI";"PIAZZA LIBERTA'";"Mercato";"lun.";"Settimanale";"Annuale";"0";"0";"11";"0";"11";"0";"0";"0";"0";"0";"11";"Asti";""
"2014";" 005113 ";"VESIME";"Piazza Vittorio Emanuele II, Piazza Dante, Via Garibaldi, Via Romita";"Mercato";"sab.";"Settimanale";"Annuale";"12";"7";"4";"1";"24";"0";"0";"0";"0";"0";"24";"Asti";""
"2014";" 005115 ";"VIARIGI";"PIAZZA MARCONI";"Mercato";"gio.";"Settimanale";"Annuale";"0";"4";"3";"0";"7";"0";"0";"0";"0";"0";"7";"Asti";""
"2014";" 006001 ";"ACQUI TERME";"CORSO ITALIA - PIAZZA SAN FRANCESCO - PORTICI SARACCO";"Mercato";"mar.";"Settimanale";"Annuale";"0";"0";"43";"0";"43";"0";"0";"3";"0";"3";"46";"Alessandria";""
"2014";" 006003 ";"ALESSANDRIA";"PIAZZA PEROSI";"Mercato";"lun.";"Settimanale";"Annuale";"0";"12";"20";"5";"37";"0";"0";"0";"0";"0";"37";"Alessandria";""
"2014";" 006003 ";"ALESSANDRIA";"PIAZZA DELLE SCUOLE - MANDROGNE";"Mercato";"gio.";"Settimanale";"Annuale";"0";"3";"0";"0";"3";"0";"0";"1";"1";"2";"5";"Alessandria";""
"2014";" 006003 ";"ALESSANDRIA";"PIAZZA C. BATTISTI - SAN GIULIANO VECCHIO";"Mercato";"ven.";"Settimanale";"Annuale";"0";"3";"0";"0";"3";"0";"0";"0";"0";"0";"3";"Alessandria";""
"2014";" 004067 ";"CHERASCO";"VIA VITTORIO EMANUELE - CHERASCO";"Mercato";"gio.";"Settimanale";"Annuale";"2";"7";"18";"0";"27";"1";"0";"5";"0";"6";"33";"Cuneo";""
"2014";" 004081 ";"DOGLIANI";"P.ZZA CARLO ALBERTO/P.ZZA CONFRATERNITA";"Mercato";"sab.";"Settimanale";"Annuale";"0";"5";"1";"6";"12";"0";"0";"0";"0";"0";"12";"Cuneo";""
"2014";" 004089 ";"FOSSANO";"Piazza Castello";"Mercato";"lun. mar. mer. gio. ven. sab. dom.";"Settimanale";"Stagionale";"0";"0";"0";"0";"0";"0";"0";"0";"4";"4";"4";"Cuneo";""
"2014";" 004095 ";"GARESSIO";"PIAZZA B. D. INDEMINI";"Mercato";"ven.";"Settimanale";"Annuale";"0";"6";"19";"3";"28";"0";"1";"0";"0";"1";"29";"Cuneo";""
"2014";" 004110 ";"LIMONE PIEMONTE";"VIA ROMA";"Mercato";"gio.";"Settimanale";"Annuale";"0";"11";"30";"3";"44";"0";"0";"0";"0";"0";"44";"Cuneo";""
"2014";" 004143 ";"MORETTA";"Piazza Castello";"Mercato";"lun.";"Settimanale";"Annuale";"0";"11";"29";"1";"41";"0";"2";"8";"0";"10";"51";"Cuneo";""
"2014";" 004143 ";"MORETTA";"Piazza Castello";"Posteggio isolato";"mar. mer. gio. ven. sab.";"Settimanale";"Annuale";"0";"1";"0";"0";"1";"0";"0";"0";"0";"0";"1";"Cuneo";""
"2014";" 004179 ";"RACCONIGI";"CENTRO STORICO";"Mercato";"gio.";"Settimanale";"Annuale";"0";"21";"56";"6";"83";"0";"3";"5";"4";"12";"95";"Cuneo";""
"2014";" 004181 ";"RIFREDDO";"PIAZZA VITTORIA";"Mercato";"mar.";"Settimanale";"Annuale";"4";"0";"0";"0";"4";"2";"0";"0";"3";"5";"9";"Cuneo";""
"2014";" 004210 ";"SAN MICHELE MONDOVI'";"Piazza Umberto I";"Mercato";"ven.";"Settimanale";"Annuale";"0";"3";"7";"0";"10";"0";"4";"5";"2";"11";"21";"Cuneo";""
"2014";" 004215 ";"SAVIGLIANO";"Piazza Monviso Battitore";"Posteggio isolato";"mar.";"Quindicinale";"Annuale";"0";"0";"1";"0";"1";"0";"0";"0";"0";"0";"1";"Cuneo";""
"2014";" 004228 ";"TORRE SAN GIORGIO";"VIA MAESTRA ADOLFO SARTI N. 17";"Mercato";"gio.";"Settimanale";"Annuale";"0";"1";"0";"0";"1";"2";"1";"0";"1";"4";"5";"Cuneo";""
"2014";" 004233 ";"VALDIERI";"FRAZIONE ANDONNO - PIAZZA SANT'EUSEBIO";"Mercato";"mer.";"Settimanale";"Annuale";"0";"0";"0";"0";"0";"0";"2";"2";"2";"6";"6";"Cuneo";""
"2014";" 004243 ";"VIGNOLO";"P.ZZA GRANDE - VIGNOLO";"Mercato";"mer.";"Settimanale";"Annuale";"0";"5";"0";"1";"6";"0";"1";"11";"0";"12";"18";"Cuneo";""
"2014";" 004248 ";"VINADIO";"Bagni di Vinadio";"Mercato";"lun.";"Settimanale";"Annuale";"0";"0";"0";"0";"0";"0";"1";"2";"1";"4";"4";"Cuneo";""
"2014";" 005005 ";"ASTI";"CORSO ALLA VITTORIA ANGOLO CORSO EINAUDI";"Posteggio isolato";"lun. mar. mer. gio. ven. sab. dom.";"Settimanale";"Stagionale";"0";"0";"0";"0";"0";"0";"1";"0";"0";"1";"1";"Asti";""
"2014";" 005005 ";"ASTI";"CORSO SAVONA";"Posteggio isolato";"lun. mar. mer. gio. ven. sab. dom.";"Settimanale";"Stagionale";"0";"1";"0";"0";"1";"0";"0";"0";"0";"0";"1";"Asti";""
"2014";" 005005 ";"ASTI";"Viale Pilone";"Mercato";"lun. gio.";"Settimanale";"Annuale";"0";"0";"0";"0";"0";"0";"4";"0";"0";"4";"4";"Asti";""
"2014";" 005005 ";"ASTI";"CORSO ALESSANDRIA";"Posteggio isolato";"lun. mar. mer. gio. ven. sab. dom.";"Settimanale";"Stagionale";"0";"0";"0";"1";"1";"0";"0";"0";"0";"0";"1";"Asti";""
"2014";" 005005 ";"ASTI";"CORSO CASALE";"Posteggio isolato";"lun. mar. mer. gio. ven. sab. dom.";"Settimanale";"Stagionale";"0";"0";"0";"0";"0";"0";"1";"0";"0";"1";"1";"Asti";""
"2014";" 005014 ";"CALLIANO";"CALLIANO - PIAZZA MARCONI";"Mercato";"lun.";"Settimanale";"Annuale";"0";"1";"0";"0";"1";"0";"4";"5";"0";"9";"10";"Asti";""
"2014";" 005028 ";"CASTELLO DI ANNONE";"FRAZIONE CROCETTA";"Mercato";"lun.";"Settimanale";"Annuale";"0";"2";"0";"0";"2";"0";"0";"0";"0";"0";"2";"Asti";""
"2014";" 005080 ";"NIZZA MONFERRATO";"PIAZZA GARIBALDI (AREA MERCATALE)";"Mercato";"ven.";"Settimanale";"Annuale";"0";"1";"71";"0";"72";"0";"0";"19";"0";"19";"91";"Asti";""
"2014";" 005097 ";"SAN DAMIANO D'ASTI";"PIAZZA ALFIERI";"Mercato";"lun.";"Settimanale";"Annuale";"0";"20";"0";"0";"20";"0";"0";"0";"0";"0";"20";"Asti";""
"2014";" 005097 ";"SAN DAMIANO D'ASTI";"CORSO ROMA";"Mercato";"lun.";"Settimanale";"Annuale";"0";"0";"46";"0";"46";"0";"0";"0";"0";"0";"46";"Asti";""
"2014";" 006001 ";"ACQUI TERME";"PIAZZA MAGGIORINO FERRARIS";"Mercato";"mar.";"Settimanale";"Annuale";"0";"9";"10";"0";"19";"0";"2";"2";"0";"4";"23";"Alessandria";""
"2014";" 006003 ";"ALESSANDRIA";"PIAZZA DELLA SCUOLE - CASTELCERIOLO";"Mercato";"gio.";"Settimanale";"Annuale";"0";"2";"0";"0";"2";"0";"1";"2";"1";"4";"6";"Alessandria";""
"2014";" 005028 ";"CASTELLO DI ANNONE";"piazza medici";"Mercato";"mar.";"Settimanale";"Annuale";"0";"1";"1";"0";"2";"0";"3";"3";"2";"8";"10";"Asti";""
"2014";" 005075 ";"MONTECHIARO D'ASTI";"PIAZZA UMBERTO I";"Mercato";"mar.";"Settimanale";"Annuale";"0";"6";"4";"0";"10";"0";"0";"0";"0";"0";"10";"Asti";""
"2014";" 005096 ";"ROCCHETTA TANARO";"Piazza del gioco del pallone";"Mercato";"gio.";"Settimanale";"Annuale";"0";"3";"1";"0";"4";"0";"2";"4";"2";"8";"12";"Asti";""
"2014";" 006003 ";"ALESSANDRIA";"PIAZZA GARIBALDI";"Mercato";"sab.";"Settimanale";"Annuale";"0";"0";"90";"0";"90";"0";"0";"0";"0";"0";"90";"Alessandria";""
"2014";" 006003 ";"ALESSANDRIA";"PIAZZA DELLA CHIESA - VALMADONNA";"Mercato";"gio. sab.";"Settimanale";"Annuale";"0";"0";"0";"0";"0";"0";"2";"1";"0";"3";"3";"Alessandria";""
"2014";" 006003 ";"ALESSANDRIA";"PIAZZETTA DELLA LEGA";"Mercato";"sab.";"Quindicinale";"Annuale";"0";"0";"0";"20";"20";"0";"0";"0";"0";"0";"20";"Alessandria";""
"2014";" 006003 ";"ALESSANDRIA";"PIAZZA CERIANA";"Mercato";"lun.";"Settimanale";"Annuale";"0";"8";"19";"1";"28";"0";"2";"1";"0";"3";"31";"Alessandria";""
"2014";" 006043 ";"CASSINE";"PIAZZA ITALIA";"Posteggio isolato";"mer.";"Settimanale";"Annuale";"0";"1";"0";"0";"1";"0";"0";"0";"0";"0";"1";"Alessandria";""
"2014";" 006081 ";"GAVI";"Piazza Dante";"Mercato";"dom.";"Settimanale";"Annuale";"19";"0";"0";"0";"19";"3";"0";"0";"0";"3";"22";"Alessandria";""
"2014";" 006138 ";"POZZOLO FORMIGARO";"Piazza Italia - Piazza Matteotti";"Mercato";"mer.";"Settimanale";"Annuale";"0";"5";"10";"0";"15";"0";"1";"5";"1";"7";"22";"Alessandria";""
"2014";" 006161 ";"SEZZADIO";"VIA LANZAVECCHIA";"Mercato";"ven.";"Settimanale";"Annuale";"0";"4";"3";"1";"8";"0";"0";"1";"0";"1";"9";"Alessandria";""
"2014";" 006179 ";"VIGNALE MONFERRATO";"PiazzaMezzadra";"Mercato";"mer.";"Settimanale";"Annuale";"0";"5";"6";"0";"11";"1";"0";"0";"1";"2";"13";"Alessandria";""
"2014";" 096012 ";"CANDELO";"VIA CIMITERO";"Mercato";"sab.";"Settimanale";"Annuale";"0";"6";"3";"3";"12";"0";"4";"6";"0";"10";"22";"Biella";""
"2014";" 096020 ";"COSSATO";"PIAZZA C.R.I.";"Mercato";"sab.";"Settimanale";"Annuale";"0";"11";"0";"2";"13";"1";"25";"7";"7";"40";"53";"Biella";""
"2014";" 006074 ";"FRESONARA";"Piazza Don Orione";"Mercato";"lun.";"Settimanale";"Annuale";"0";"2";"3";"0";"5";"1";"1";"1";"2";"5";"10";"Alessandria";""
"2014";" 006076 ";"FUBINE";"Piazza Garibaldi";"Posteggio isolato";"mar.";"Quindicinale";"Annuale";"0";"1";"0";"0";"1";"0";"0";"0";"0";"0";"1";"Alessandria";""
"2014";" 006109 ";"MORANO SUL PO";"PIAZZA GIOVANNI PAOLO II 1978 = 2005";"Mercato";"gio.";"Settimanale";"Annuale";"3";"4";"5";"0";"12";"3";"0";"0";"0";"3";"15";"Alessandria";""
"2014";" 006114 ";"NOVI LIGURE";"CORSO MARENCO";"Posteggio isolato";"gio.";"Settimanale";"Annuale";"0";"0";"1";"0";"1";"0";"0";"0";"0";"0";"1";"Alessandria";""
"2014";" 006121 ";"OVADA";"VIA CAIROLI - PIAZZA CAPPUCCINI - PIAZZA S.DOMENICO - P.ZZA ASSUNTA-P.ZZA MAZZINI - P.ZZA GARIBALDI";"Mercato";"mer.";"Settimanale";"Annuale";"0";"13";"37";"4";"54";"0";"0";"0";"1";"1";"55";"Alessandria";""
"2014";" 006122 ";"OVIGLIO";"piazza Vitt.Veneto";"Mercato";"gio.";"Settimanale";"Annuale";"0";"3";"4";"0";"7";"0";"0";"0";"0";"0";"7";"Alessandria";""
"2014";" 006144 ";"RIVALTA BORMIDA";"p.zza vittorio veneto";"Mercato";"mer.";"Settimanale";"Annuale";"0";"4";"7";"2";"13";"0";"0";"0";"0";"0";"13";"Alessandria";""
"2014";" 006147 ";"ROCCA GRIMALDA";"Piazza S. Borgatta - Piazza Matteotti";"Mercato";"ven.";"Settimanale";"Annuale";"0";"0";"1";"0";"1";"0";"2";"4";"0";"6";"7";"Alessandria";""
"2014";" 006174 ";"TORTONA";"PIAZZA MILANO";"Mercato";"sab.";"Settimanale";"Annuale";"0";"25";"90";"3";"118";"0";"1";"2";"0";"3";"121";"Alessandria";""
"2014";" 006177 ";"VALENZA";"VIA VITTORIO AMEDEO- P.ZZA XXXI MARTIRI-C.SO GARIBALDI-P.ZZA GRAMSCI-V.LE OLIVA";"Mercato";"sab.";"Settimanale";"Annuale";"0";"14";"81";"3";"98";"0";"8";"13";"1";"22";"120";"Alessandria";""
"2014";" 006177 ";"VALENZA";"PIAZZA FOGLIABELLA";"Mercato";"gio.";"Settimanale";"Annuale";"0";"3";"0";"0";"3";"0";"8";"0";"1";"9";"12";"Alessandria";""
"2014";" 096010 ";"CAMBURZANO";"Via C. Lampo 1";"Mercato";"gio.";"Settimanale";"Annuale";"1";"0";"0";"0";"1";"1";"0";"0";"0";"1";"2";"Biella";""
"2014";" 096020 ";"COSSATO";"PIAZZA PEROTTI";"Posteggio isolato";"lun. mar. mer. gio. ven. sab.";"Settimanale";"Stagionale";"0";"1";"0";"0";"1";"0";"0";"0";"0";"0";"1";"Biella";""
"2014";" 096020 ";"COSSATO";"PIAZZALE CIMITERO";"Posteggio isolato";"mar. mer. gio. ven. sab. dom.";"Settimanale";"Annuale";"0";"0";"1";"0";"1";"0";"0";"0";"0";"0";"1";"Biella";""
"2014";" 096048 ";"PORTULA";"Fraz. Castagnea";"Mercato";"ven.";"Settimanale";"Annuale";"0";"2";"0";"0";"2";"0";"1";"0";"1";"2";"4";"Biella";""
"2014";" 006021 ";"BOSCO MARENGO";"Piazza Mercato";"Mercato";"mer.";"Settimanale";"Annuale";"1";"7";"7";"1";"16";"0";"0";"4";"1";"5";"21";"Alessandria";""
"2014";" 006023 ";"BOZZOLE";"PIAZZA UMBERTO PRIMO";"Mercato";"lun.";"Settimanale";"Annuale";"0";"1";"2";"0";"3";"0";"0";"0";"0";"0";"3";"Alessandria";""
"2014";" 006043 ";"CASSINE";"Piazza Cadorna- Via delle Mura";"Mercato";"sab.";"Settimanale";"Annuale";"0";"3";"1";"8";"12";"0";"1";"0";"4";"5";"17";"Alessandria";""
"2014";" 006054 ";"CASTELSPINA";"PIAZZA BOCCASSO 3";"Mercato";"gio.";"Settimanale";"Annuale";"0";"3";"3";"1";"7";"0";"0";"0";"0";"0";"7";"Alessandria";""
"2014";" 006122 ";"OVIGLIO";"vicinanze piazza roma";"Posteggio isolato";"lun. mar. mer. gio. ven. sab.";"Settimanale";"Stagionale";"0";"0";"0";"0";"0";"0";"0";"0";"1";"1";"1";"Alessandria";""
"2014";" 006163 ";"SOLERO";"PIAZZA DELLA LIBERTA'";"Mercato";"lun.";"Settimanale";"Annuale";"0";"6";"2";"0";"8";"7";"0";"0";"0";"7";"15";"Alessandria";""
"2014";" 006176 ";"TRISOBBIO";"VIA GARIBALDI";"Mercato";"mer. gio.";"Settimanale";"Annuale";"3";"0";"0";"0";"3";"0";"0";"0";"0";"0";"3";"Alessandria";""
"2014";" 096004 ";"BIELLA";"P.ZZA MARTIRI LIBERTA'";"Mercato";"mar. ven.";"Settimanale";"Annuale";"0";"20";"35";"11";"66";"0";"4";"16";"7";"27";"93";"Biella";""
"2014";" 096029 ";"LESSONA";"Piazza Mario Graziola";"Mercato";"ven.";"Settimanale";"Annuale";"0";"0";"0";"0";"0";"0";"5";"4";"1";"10";"10";"Biella";""
"2014";" 096035 ";"MONGRANDO";"piazza comunale";"Posteggio isolato";"ven.";"Settimanale";"Annuale";"0";"1";"0";"0";"1";"0";"0";"0";"0";"0";"1";"Biella";""
"2014";" 006013 ";"BASSIGNANA";"PIAZZA LIBERTA'";"Mercato";"ven.";"Settimanale";"Annuale";"0";"4";"7";"0";"11";"0";"0";"0";"1";"1";"12";"Alessandria";""
"2014";" 006036 ";"CARTOSIO";"PIAZZA UMBERTO TERRACINI";"Mercato";"lun.";"Settimanale";"Annuale";"0";"2";"1";"0";"3";"0";"0";"0";"0";"0";"3";"Alessandria";""
"2014";" 006039 ";"CASALE MONFERRATO";"PIAZZA CASTELLO";"Mercato";"ven.";"Settimanale";"Annuale";"0";"42";"150";"8";"200";"0";"0";"0";"0";"0";"200";"Alessandria";""
"2014";" 006114 ";"NOVI LIGURE";"VIA GARIBALDI";"Mercato";"mar.";"Settimanale";"Annuale";"0";"4";"0";"1";"5";"0";"0";"0";"0";"0";"5";"Alessandria";""
"2014";" 006134 ";"PONTI";"PIAZZA CADUTI";"Mercato";"sab.";"Settimanale";"Annuale";"0";"0";"0";"0";"0";"1";"2";"1";"0";"4";"4";"Alessandria";""
"2014";" 006154 ";"SAN SALVATORE MONFERRATO";"P.zza dei Caduti";"Posteggio isolato";"ven.";"Settimanale";"Annuale";"0";"1";"0";"0";"1";"0";"0";"0";"0";"0";"1";"Alessandria";""
"2014";" 096003 ";"BENNA";"VIA UMBERTO (PIAZZA ADIACENTE IL MUNICIPIO)";"Mercato";"mer.";"Settimanale";"Annuale";"0";"3";"0";"0";"3";"0";"0";"1";"0";"1";"4";"Biella";""
"2014";" 096019 ";"COGGIOLA";"P.zza XXV Aprile";"Mercato";"sab.";"Settimanale";"Annuale";"0";"4";"0";"0";"4";"0";"0";"0";"0";"0";"4";"Biella";""
"2014";" 096035 ";"MONGRANDO";"piazza comunale";"Mercato";"sab.";"Settimanale";"Annuale";"0";"6";"3";"0";"9";"0";"0";"2";"0";"2";"11";"Biella";""
"2014";" 096044 ";"PIEDICAVALLO";"PIAZZA POLIFUNZIONALE";"Mercato";"mer.";"Settimanale";"Stagionale";"0";"0";"0";"0";"0";"0";"2";"2";"0";"4";"4";"Biella";""
"2014";" 006018 ";"BORGHETTO DI BORBERA";"Piazza della chiesa";"Mercato";"lun.";"Settimanale";"Annuale";"1";"2";"3";"0";"6";"0";"1";"0";"1";"2";"8";"Alessandria";""
"2014";" 006033 ";"CARPENETO";"VIA TORINO";"Mercato";"mar.";"Settimanale";"Annuale";"5";"0";"0";"0";"5";"0";"0";"0";"0";"0";"5";"Alessandria";""
"2014";" 006042 ";"CASSANO SPINOLA";"Piazza Millelire";"Mercato";"ven.";"Settimanale";"Annuale";"0";"3";"1";"2";"6";"0";"0";"1";"0";"1";"7";"Alessandria";""
"2014";" 006078 ";"GAMALERO";"PIAZZA ALDO MORO";"Mercato";"mer.";"Settimanale";"Annuale";"2";"2";"1";"2";"7";"2";"0";"1";"0";"3";"10";"Alessandria";""
"2014";" 006091 ";"MASIO";"Piazza Borgo Nuovo";"Mercato";"mer.";"Settimanale";"Annuale";"0";"3";"3";"1";"7";"0";"0";"0";"0";"0";"7";"Alessandria";""
"2014";" 006133 ";"PONTESTURA";"Piazza Castello";"Mercato";"ven.";"Settimanale";"Annuale";"3";"3";"3";"1";"10";"0";"0";"0";"0";"0";"10";"Alessandria";""
"2014";" 006154 ";"SAN SALVATORE MONFERRATO";"PIAZZA CARMAGNOLA E PIAZZETTA DEI CADUTI";"Mercato";"sab.";"Settimanale";"Annuale";"0";"5";"8";"0";"13";"0";"4";"2";"1";"7";"20";"Alessandria";""
"2014";" 006177 ";"VALENZA";"PIAZZALE CIMITERO";"Posteggio isolato";"lun. mar. mer. gio. ven. sab. dom.";"Settimanale";"Annuale";"0";"0";"1";"0";"1";"0";"0";"0";"0";"0";"1";"Alessandria";""
"2014";" 096004 ";"BIELLA";"PIAZZA COSSATO";"Mercato";"lun. mar. mer. gio. ven. sab. dom.";"Settimanale";"Annuale";"0";"2";"0";"0";"2";"0";"0";"0";"0";"0";"2";"Biella";""
"2014";" 096040 ";"OCCHIEPPO INFERIORE";"piazza del Pioppo";"Mercato";"ven.";"Settimanale";"Annuale";"0";"3";"0";"0";"3";"9";"0";"0";"1";"10";"13";"Biella";""
"2014";" 006012 ";"BASALUZZO";"VIA MARCONI";"Mercato";"dom.";"Settimanale";"Annuale";"0";"0";"0";"7";"7";"0";"0";"0";"5";"5";"12";"Alessandria";""
"2014";" 006075 ";"FRUGAROLO";"VIA CAVOUR";"Mercato";"mar.";"Settimanale";"Annuale";"0";"5";"6";"0";"11";"1";"2";"1";"1";"5";"16";"Alessandria";""
"2014";" 006093 ";"MERANA";"Via della Liberazione";"Mercato";"lun.";"Settimanale";"Annuale";"0";"1";"4";"0";"5";"0";"0";"0";"0";"0";"5";"Alessandria";""
"2014";" 006140 ";"PREDOSA";"Piazza Matteotti";"Mercato";"ven.";"Settimanale";"Annuale";"0";"6";"7";"0";"13";"0";"0";"0";"1";"1";"14";"Alessandria";""
"2014";" 006160 ";"SERRAVALLE SCRIVIA";"PIAZZA PAOLO BOSIO";"Mercato";"mar.";"Settimanale";"Annuale";"0";"9";"15";"1";"25";"0";"0";"4";"0";"4";"29";"Alessandria";""
"2014";" 006173 ";"TICINETO";"PIAZZA MARTIRI DELLA LIBERTA'";"Posteggio isolato";"sab.";"Settimanale";"Annuale";"0";"1";"0";"0";"1";"0";"0";"0";"0";"0";"1";"Alessandria";""
"2014";" 096039 ";"NETRO";"PIAZZA XXSETTEMBRE /VIA IV NOVEMBRE/PIAZZA PIAVE";"Mercato";"mer.";"Settimanale";"Annuale";"1";"2";"2";"0";"5";"1";"1";"1";"2";"5";"10";"Biella";""
"2014";" 006009 ";"ARQUATA SCRIVIA";"VIA LIBARNA - PIAZZA S. BERTELLI";"Mercato";"sab.";"Settimanale";"Annuale";"0";"6";"12";"1";"19";"0";"2";"0";"0";"2";"21";"Alessandria";""
"2014";" 006012 ";"BASALUZZO";"Piazza XXV Aprile";"Mercato";"dom.";"Settimanale";"Annuale";"0";"9";"20";"2";"31";"0";"0";"0";"0";"0";"31";"Alessandria";""
"2014";" 006015 ";"BERGAMASCO";"PIAZZA BARBERIS";"Mercato";"mer.";"Settimanale";"Annuale";"1";"1";"1";"0";"3";"0";"0";"0";"0";"0";"3";"Alessandria";""
"2014";" 006020 ";"BORGO SAN MARTINO";"VIA SANTA MARIA";"Mercato";"mer.";"Settimanale";"Annuale";"0";"7";"9";"0";"16";"0";"0";"0";"0";"0";"16";"Alessandria";""
"2014";" 006039 ";"CASALE MONFERRATO";"PIAZZA CASTELLO";"Mercato";"mar.";"Settimanale";"Annuale";"0";"42";"150";"8";"200";"0";"0";"0";"0";"0";"200";"Alessandria";""
"2014";" 006047 ";"CASTELLAZZO BORMIDA";"PIAZZA VITTORIO EMANUELE II";"Mercato";"sab.";"Settimanale";"Annuale";"0";"8";"9";"0";"17";"0";"0";"1";"1";"2";"19";"Alessandria";""
"2014";" 006049 ";"CASTELLETTO D'ORBA";"PIAZZA MARCONI";"Mercato";"ven.";"Settimanale";"Annuale";"0";"2";"2";"0";"4";"0";"0";"0";"0";"0";"4";"Alessandria";""
"2014";" 006077 ";"GABIANO";"frazione Piagera";"Mercato";"dom.";"Settimanale";"Annuale";"0";"8";"22";"66";"96";"0";"8";"22";"45";"75";"171";"Alessandria";""
"2014";" 006094 ";"MIRABELLO MONFERRATO";"PIAZZA DELLA LIBERTA'";"Mercato";"gio.";"Settimanale";"Annuale";"0";"5";"6";"0";"11";"0";"4";"2";"2";"8";"19";"Alessandria";""
"2014";" 006114 ";"NOVI LIGURE";"PIAZZA DELLEPIANE";"Mercato";"gio.";"Settimanale";"Annuale";"0";"0";"8";"0";"8";"0";"0";"1";"0";"1";"9";"Alessandria";""
"2014";" 006123 ";"OZZANO MONFERRATO";"PIAZZA VITTORIO VENETO";"Mercato";"mar.";"Settimanale";"Annuale";"0";"5";"3";"0";"8";"0";"0";"0";"0";"0";"8";"Alessandria";""
"2014";" 006151 ";"SALE";"VIA MARCONI";"Mercato";"mar.";"Settimanale";"Annuale";"0";"12";"24";"1";"37";"0";"1";"9";"2";"12";"49";"Alessandria";""
"2014";" 006167 ";"STAZZANO";"Piazza Risorgimento";"Mercato";"mer.";"Settimanale";"Annuale";"0";"1";"3";"0";"4";"0";"0";"0";"0";"0";"4";"Alessandria";""
"2014";" 096004 ";"BIELLA";"PIAZZA FALCONE";"Mercato";"lun. gio. sab.";"Settimanale";"Annuale";"0";"41";"164";"20";"225";"0";"34";"92";"18";"144";"369";"Biella";""
"2014";" 096004 ";"BIELLA";"VILAGGIO GESCAL";"Mercato";"gio.";"Settimanale";"Annuale";"0";"3";"0";"0";"3";"0";"2";"0";"0";"2";"5";"Biella";""
"2014";" 096004 ";"BIELLA";"PIAZZA POLENTA";"Mercato";"ven.";"Settimanale";"Annuale";"0";"2";"0";"0";"2";"0";"1";"0";"0";"1";"3";"Biella";""
"2014";" 096020 ";"COSSATO";"PIAZZA C.R.I.";"Mercato";"mer.";"Settimanale";"Annuale";"0";"1";"92";"0";"93";"0";"0";"19";"0";"19";"112";"Biella";""
"2014";" 096028 ";"GRAGLIA";"PIAZZA GIACOMO CANTONE";"Mercato";"mar.";"Settimanale";"Annuale";"0";"3";"2";"0";"5";"0";"2";"3";"1";"6";"11";"Biella";""
"2014";" 006106 ";"MONTECHIARO D'ACQUI";"PIAZZA EUROPA";"Mercato";"lun.";"Settimanale";"Annuale";"0";"2";"3";"2";"7";"5";"2";"2";"3";"12";"19";"Alessandria";""
"2014";" 006178 ";"VALMACCA";"PIAZZA BISIO";"Mercato";"gio.";"Settimanale";"Annuale";"0";"1";"1";"0";"2";"0";"2";"4";"0";"6";"8";"Alessandria";""
"2014";" 006180 ";"VIGNOLE BORBERA";"PIAZZA FIGINI";"Mercato";"ven.";"Settimanale";"Annuale";"0";"5";"9";"2";"16";"0";"0";"0";"0";"0";"16";"Alessandria";""
"2014";" 096002 ";"ANDORNO MICCA";"PIAZZA GRAMSCI - VIA PEROSI - PIAZZA PAPA GIOVANNI XXIII";"Mercato";"lun.";"Settimanale";"Annuale";"0";"7";"11";"2";"20";"0";"6";"6";"2";"14";"34";"Biella";""
"2014";" 096021 ";"CREVACUORE";"PIAZZA MARTIRI";"Mercato";"sab.";"Settimanale";"Annuale";"0";"2";"3";"0";"5";"6";"3";"1";"0";"10";"15";"Biella";""
"2014";" 006025 ";"CABELLA LIGURE";"PIAZZA VITTORIA ZONA GIARDINI";"Mercato";"sab.";"Quindicinale";"Annuale";"2";"1";"0";"0";"3";"4";"0";"0";"0";"4";"7";"Alessandria";""
"2014";" 006059 ";"CERRINA MONFERRATO";"P.ZZA FIERISTICA ESPOSITIVA VIA CASALE MOLINO";"Mercato";"dom.";"Settimanale";"Annuale";"0";"5";"14";"0";"19";"0";"7";"15";"4";"26";"45";"Alessandria";""
"2014";" 006125 ";"PARETO";"P.ZZA CESARE BATTISTI";"Mercato";"lun.";"Settimanale";"Annuale";"0";"2";"4";"0";"6";"0";"0";"0";"0";"0";"6";"Alessandria";""
"2014";" 006142 ";"QUATTORDIO";"PIAZZA PIONIERI D'INDUSTRIA";"Mercato";"gio.";"Settimanale";"Annuale";"0";"4";"2";"1";"7";"4";"2";"1";"0";"7";"14";"Alessandria";""
"2014";" 006154 ";"SAN SALVATORE MONFERRATO";"PIAZZA CARMAGNOLA E PIAZZETTA DEI CADUTI";"Mercato";"mer.";"Settimanale";"Annuale";"0";"6";"11";"0";"17";"0";"2";"0";"1";"3";"20";"Alessandria";""
"2014";" 096004 ";"BIELLA";"ANTISTANTE LA CHIESA";"Posteggio isolato";"lun.";"Settimanale";"Annuale";"0";"1";"0";"0";"1";"0";"0";"0";"0";"0";"1";"Biella";""
"2014";" 096032 ";"MASSERANO";"VIA ROMA";"Mercato";"mer.";"Settimanale";"Annuale";"0";"2";"0";"0";"2";"3";"1";"2";"1";"7";"9";"Biella";""
"2014";" 096042 ";"PETTINENGO";"FRAZIONE LIVERA";"Mercato";"mer.";"Settimanale";"Annuale";"0";"3";"2";"2";"7";"0";"0";"0";"0";"0";"7";"Biella";""
"2014";" 006017 ";"BISTAGNO";"PIAZZA MONTEVERDE";"Mercato";"mer. dom.";"Settimanale";"Annuale";"4";"0";"3";"1";"8";"1";"0";"0";"1";"2";"10";"Alessandria";""
"2014";" 006040 ";"CASALNOCETO";"piazza Dante Alighieri";"Mercato";"gio.";"Settimanale";"Annuale";"0";"3";"1";"1";"5";"0";"0";"0";"0";"0";"5";"Alessandria";""
"2014";" 006051 ";"CASTELLETTO MONFERRATO";"Piazza Astori";"Mercato";"mar.";"Settimanale";"Annuale";"0";"4";"5";"2";"11";"0";"0";"0";"0";"0";"11";"Alessandria";""
"2014";" 006114 ";"NOVI LIGURE";"PIAZZA XX SETTEMBRE";"Mercato";"gio.";"Settimanale";"Annuale";"0";"0";"96";"0";"96";"0";"0";"0";"0";"0";"96";"Alessandria";""
"2014";" 006114 ";"NOVI LIGURE";"VIA ROMA";"Mercato";"gio.";"Settimanale";"Annuale";"0";"1";"3";"1";"5";"0";"0";"0";"0";"0";"5";"Alessandria";""
"2014";" 006115 ";"OCCIMIANO";"Piazza Carlo Alberto (mercoledï¿½) Piazza Oratorio Don Bosco (venerdï¿½)";"Mercato";"mer. ven.";"Settimanale";"Annuale";"0";"5";"5";"0";"10";"0";"1";"1";"2";"4";"14";"Alessandria";""
"2014";" 006116 ";"ODALENGO GRANDE";"PIAZZA CADUTI DI NASSIRYA";"Mercato";"sab.";"Settimanale";"Annuale";"0";"6";"6";"4";"16";"0";"2";"6";"1";"9";"25";"Alessandria";""
"2014";" 006130 ";"PIOVERA";"PIAZZALE DI VIA CADUTI DI NASSYRIA";"Mercato";"ven.";"Settimanale";"Annuale";"0";"2";"3";"1";"6";"0";"1";"1";"0";"2";"8";"Alessandria";""
"2014";" 006170 ";"TASSAROLO";"VIA DEI MARTIRI";"Mercato";"mar. ven.";"Settimanale";"Annuale";"0";"2";"1";"0";"3";"0";"0";"0";"0";"0";"3";"Alessandria";""
"2014";" 006181 ";"VIGUZZOLO";"Via Circonvallazione";"Mercato";"mar.";"Settimanale";"Annuale";"0";"3";"8";"0";"11";"0";"0";"0";"0";"0";"11";"Alessandria";""
"2014";" 096026 ";"GAGLIANICO";"Piazza Repubblica";"Mercato";"ven.";"Settimanale";"Annuale";"0";"7";"4";"0";"11";"9";"0";"0";"0";"9";"20";"Biella";""
"2014";" 096041 ";"OCCHIEPPO SUPERIORE";"Piazza Levis";"Mercato";"mer.";"Settimanale";"Annuale";"0";"4";"4";"0";"8";"2";"2";"4";"1";"9";"17";"Biella";""
"2014";" 096048 ";"PORTULA";"Fraz. Granero";"Mercato";"ven.";"Settimanale";"Annuale";"0";"0";"0";"0";"0";"0";"4";"2";"1";"7";"7";"Biella";""
"2014";" 096048 ";"PORTULA";"Fraz. Chiesa";"Mercato";"lun.";"Settimanale";"Annuale";"0";"2";"1";"0";"3";"0";"0";"1";"1";"2";"5";"Biella";""
"2014";" 006043 ";"CASSINE";"Piazza Italia";"Mercato";"sab.";"Settimanale";"Annuale";"0";"0";"9";"1";"10";"0";"0";"10";"0";"10";"20";"Alessandria";""
"2014";" 006076 ";"FUBINE";"Piazza Robotti";"Posteggio isolato";"mar.";"Quindicinale";"Annuale";"0";"1";"0";"0";"1";"0";"0";"0";"0";"0";"1";"Alessandria";""
"2014";" 006114 ";"NOVI LIGURE";"VIA MARCONI";"Posteggio isolato";"gio.";"Settimanale";"Annuale";"0";"0";"1";"0";"1";"0";"0";"0";"0";"0";"1";"Alessandria";""
"2014";" 006114 ";"NOVI LIGURE";"VIA GARIBALDI";"Mercato";"sab.";"Settimanale";"Annuale";"0";"5";"0";"1";"6";"0";"1";"0";"0";"1";"7";"Alessandria";""
"2014";" 006117 ";"ODALENGO PICCOLO";"PIAZZA PIEMONTE";"Mercato";"sab.";"Settimanale";"Stagionale";"0";"1";"0";"0";"1";"0";"2";"5";"2";"9";"10";"Alessandria";""
"2014";" 006132 ";"PONTECURONE";"PIAZZA MARTIRI DELLA LIBERTA'";"Mercato";"sab.";"Settimanale";"Annuale";"0";"3";"8";"0";"11";"0";"5";"4";"5";"14";"25";"Alessandria";""
"2014";" 006136 ";"PONZONE";"piazza italia";"Mercato";"lun.";"Settimanale";"Annuale";"3";"0";"0";"3";"6";"1";"0";"0";"3";"4";"10";"Alessandria";""
"2014";" 006166 ";"SPINETO SCRIVIA";"P.ZZA MATTEOTTI";"Posteggio isolato";"lun.";"Settimanale";"Annuale";"1";"0";"0";"0";"1";"0";"0";"0";"0";"0";"1";"Alessandria";""
"2014";" 006173 ";"TICINETO";"PIAZZA MARTIRI DELLA LIBERTA'";"Mercato";"mer.";"Settimanale";"Annuale";"0";"4";"2";"0";"6";"3";"0";"0";"1";"4";"10";"Alessandria";""
"2014";" 096004 ";"BIELLA";"Biella Chiavazza";"Mercato";"mar. gio. sab.";"Settimanale";"Annuale";"0";"7";"3";"0";"10";"0";"0";"0";"0";"0";"10";"Biella";""
"2014";" 096016 ";"CAVAGLIA'";"PIAZZA PALATUCCI";"Mercato";"mer.";"Settimanale";"Annuale";"13";"22";"34";"3";"72";"0";"5";"15";"3";"23";"95";"Biella";""
"2014";" 096034 ";"MIAGLIANO";"PIAZZA MARTIRI DELLA LIBERTA'";"Mercato";"gio.";"Settimanale";"Annuale";"0";"2";"1";"0";"3";"0";"0";"0";"0";"0";"3";"Biella";""
"2014";" 096047 ";"PONDERANO";"PIAZZA ALPINI D'ITALIA";"Mercato";"mar.";"Settimanale";"Annuale";"0";"7";"2";"0";"9";"0";"0";"2";"1";"3";"12";"Biella";""
"2014";" 006012 ";"BASALUZZO";"PIAZZA XV APRILE";"Mercato";"dom.";"Settimanale";"Annuale";"0";"0";"16";"0";"16";"0";"0";"11";"0";"11";"27";"Alessandria";""
"2014";" 006053 ";"CASTELNUOVO SCRIVIA";"Piazza Vittorio Emanuele II";"Mercato";"gio.";"Settimanale";"Annuale";"0";"9";"27";"1";"37";"0";"1";"0";"1";"2";"39";"Alessandria";""
"2014";" 006155 ";"SAN SEBASTIANO CURONE";"piazza mercato";"Mercato";"mer. dom.";"Settimanale";"Annuale";"0";"4";"4";"0";"8";"0";"0";"0";"0";"0";"8";"Alessandria";""
"2014";" 006177 ";"VALENZA";"VIA TRENTO";"Mercato";"mar.";"Settimanale";"Annuale";"0";"7";"0";"0";"7";"0";"3";"0";"1";"4";"11";"Alessandria";""
"2014";" 096007 ";"BRUSNENGO";"Piazza del Mercato";"Mercato";"ven.";"Settimanale";"Annuale";"0";"9";"6";"2";"17";"0";"2";"10";"0";"12";"29";"Biella";""
"2014";" 096031 ";"MASSAZZA";"P.ZZA DON VIGNA";"Mercato";"mar. ven.";"Settimanale";"Annuale";"0";"2";"1";"0";"3";"0";"0";"0";"0";"0";"3";"Biella";""
"2014";" 006011 ";"BALZOLA";"PIAZZETTA CADUTI DI NASSYRIA";"Mercato";"mer.";"Settimanale";"Annuale";"0";"4";"2";"1";"7";"0";"1";"3";"0";"4";"11";"Alessandria";""
"2014";" 006140 ";"PREDOSA";"PREDOSA";"Mercato";"ven.";"Settimanale";"Annuale";"0";"4";"2";"0";"6";"0";"0";"0";"0";"0";"6";"Alessandria";""
"2014";" 006141 ";"QUARGNENTO";"Piazza 1 Maggio";"Mercato";"sab.";"Settimanale";"Annuale";"0";"5";"3";"0";"8";"0";"3";"5";"0";"8";"16";"Alessandria";""
"2014";" 006177 ";"VALENZA";"VIALE OLIVA";"Mercato";"mer.";"Settimanale";"Annuale";"0";"0";"0";"10";"10";"0";"0";"0";"0";"0";"10";"Alessandria";""
"2014";" 096020 ";"COSSATO";"PIAZZA C.R.I.";"Mercato";"mer.";"Settimanale";"Annuale";"0";"24";"0";"7";"31";"0";"26";"1";"3";"30";"61";"Biella";""
"2014";" 096037 ";"MOTTALCIATA";"PIAZZA DEL MERCATO";"Mercato";"lun.";"Settimanale";"Annuale";"0";"0";"0";"0";"0";"4";"0";"0";"0";"4";"4";"Biella";""
"2014";" 006037 ";"CASAL CERMELLI";"Piazza Can Carlo";"Mercato";"sab.";"Settimanale";"Annuale";"2";"0";"0";"0";"2";"0";"0";"0";"0";"0";"2";"Alessandria";""
"2014";" 006068 ";"FELIZZANO";"Piazza Della Repubblica";"Mercato";"mar.";"Settimanale";"Annuale";"0";"5";"3";"1";"9";"6";"0";"0";"0";"6";"15";"Alessandria";""
"2014";" 006159 ";"SERRALUNGA DI CREA";"FRAZIONE MADONNINA - PIAZZA NUOVA";"Mercato";"mer.";"Settimanale";"Annuale";"0";"2";"0";"0";"2";"0";"2";"0";"0";"2";"4";"Alessandria";""
"2014";" 006162 ";"SILVANO D'ORBA";"PIAZZA CESARE BATTISTI";"Mercato";"lun.";"Settimanale";"Annuale";"0";"5";"8";"1";"14";"0";"0";"0";"0";"0";"14";"Alessandria";""
"2014";" 006174 ";"TORTONA";"PIAZZA MILANO";"Mercato";"mer.";"Settimanale";"Annuale";"0";"23";"89";"1";"113";"0";"3";"3";"2";"8";"121";"Alessandria";""
"2014";" 096004 ";"BIELLA";"VIA CIAPEIA";"Mercato";"mar. sab.";"Settimanale";"Annuale";"0";"2";"0";"0";"2";"0";"0";"0";"0";"0";"2";"Biella";""
"2014";" 096004 ";"BIELLA";"VIA PONDERANO";"Posteggio isolato";"mar. gio.";"Settimanale";"Annuale";"0";"1";"0";"0";"1";"0";"0";"0";"0";"0";"1";"Biella";""
"2014";" 096042 ";"PETTINENGO";"Piazza L. Vaglio";"Mercato";"mar.";"Settimanale";"Annuale";"0";"0";"0";"0";"0";"0";"2";"0";"0";"2";"2";"Biella";""
"2014";" 096049 ";"PRALUNGO";"PIAZZA LIBERTA'";"Mercato";"mar.";"Settimanale";"Annuale";"0";"1";"0";"0";"1";"2";"0";"1";"0";"3";"4";"Biella";""
"2014";" 006052 ";"CASTELNUOVO BORMIDA";"piazza marconi";"Mercato";"gio.";"Settimanale";"Annuale";"3";"0";"0";"0";"3";"0";"0";"0";"0";"0";"3";"Alessandria";""
"2014";" 006073 ";"FRASSINETO PO";"PIAZZA VITTORIO VENETO";"Mercato";"lun. sab.";"Settimanale";"Annuale";"0";"3";"6";"0";"9";"0";"0";"0";"0";"0";"9";"Alessandria";""
"2014";" 006113 ";"MURISENGO";"VIA UMBERTO I - PIAZZA DELLA VITTORIA - PIAZZA BOARIO";"Mercato";"lun.";"Settimanale";"Annuale";"0";"10";"20";"2";"32";"0";"2";"10";"1";"13";"45";"Alessandria";""
"2014";" 006121 ";"OVADA";"VIA CAIROLI -PIAZZA CAPPUCCINI-PIAZZA S.DOMENICO-PIAZZA ASSUNTA-PIAZZA MAZZINI-PIAZZA GARIBALDI";"Mercato";"sab.";"Settimanale";"Annuale";"0";"13";"36";"4";"53";"0";"0";"1";"1";"2";"55";"Alessandria";""
"2014";" 006131 ";"POMARO MONFERRATO";"POMARO MONFERRATO";"Mercato";"sab.";"Settimanale";"Annuale";"6";"0";"0";"0";"6";"0";"0";"0";"0";"0";"6";"Alessandria";""
"2014";" 096004 ";"BIELLA";"VIA ASMARA";"Mercato";"ven.";"Settimanale";"Annuale";"0";"4";"1";"0";"5";"0";"2";"0";"0";"2";"7";"Biella";""
"2014";" 096004 ";"BIELLA";"P.ZZA CISTERNA";"Mercato";"mar. mer. ven.";"Settimanale";"Annuale";"0";"2";"0";"0";"2";"0";"0";"0";"0";"0";"2";"Biella";""
"2014";" 096032 ";"MASSERANO";"VIA ROMA";"Mercato";"sab.";"Settimanale";"Annuale";"0";"2";"0";"0";"2";"2";"4";"0";"2";"8";"10";"Biella";""
"2014";" 096046 ";"POLLONE";"PIAZZA SAN ROCCO";"Mercato";"mer.";"Settimanale";"Annuale";"0";"2";"0";"0";"2";"0";"2";"5";"1";"8";"10";"Biella";""
"2014";" 006009 ";"ARQUATA SCRIVIA";"PIAZZA DEI CADUTI";"Mercato";"mer.";"Settimanale";"Annuale";"1";"6";"12";"2";"21";"0";"3";"1";"0";"4";"25";"Alessandria";""
"2014";" 006076 ";"FUBINE";"Piazza Garibaldi";"Mercato";"ven.";"Quindicinale";"Annuale";"0";"5";"2";"1";"8";"0";"5";"2";"1";"8";"16";"Alessandria";""
"2014";" 006076 ";"FUBINE";"Piazza Robotti";"Mercato";"ven.";"Quindicinale";"Annuale";"0";"4";"2";"1";"7";"0";"1";"0";"0";"1";"8";"Alessandria";""
"2014";" 006089 ";"LU";"piazza Gherzi";"Mercato";"mar.";"Settimanale";"Annuale";"0";"1";"6";"2";"9";"0";"0";"0";"0";"0";"9";"Alessandria";""
"2014";" 006095 ";"MOLARE";"PIAZZA DARIO PESCE";"Mercato";"mar. ven.";"Settimanale";"Annuale";"0";"1";"3";"1";"5";"0";"3";"1";"1";"5";"10";"Alessandria";""
"2014";" 006114 ";"NOVI LIGURE";"PIAZZA CARENZI";"Mercato";"gio.";"Settimanale";"Annuale";"0";"13";"0";"0";"13";"0";"0";"0";"0";"0";"13";"Alessandria";""
"2014";" 006165 ";"SPIGNO MONFERRATO";"PIAZZA GARIBALDI - CORSO ROMA - PIAZZA IV NOVEMBRE";"Mercato";"mer.";"Settimanale";"Annuale";"0";"2";"7";"3";"12";"0";"6";"4";"0";"10";"22";"Alessandria";""
"2014";" 006174 ";"TORTONA";"PIAZZA MILANO";"Posteggio isolato";"ven.";"Settimanale";"Annuale";"0";"1";"0";"0";"1";"0";"0";"0";"0";"0";"1";"Alessandria";""
"2014";" 006183 ";"VILLALVERNIA";"PIAZZA COMUNALE";"Mercato";"lun.";"Settimanale";"Annuale";"0";"2";"1";"0";"3";"0";"0";"0";"0";"0";"3";"Alessandria";""
"2014";" 006185 ";"VILLANOVA MONFERRATO";"Piazza Finazzi";"Mercato";"mer.";"Settimanale";"Annuale";"0";"3";"4";"0";"7";"1";"0";"0";"0";"1";"8";"Alessandria";""
"2014";" 006185 ";"VILLANOVA MONFERRATO";"Piazza Finazzi";"Mercato";"ven.";"Settimanale";"Annuale";"0";"3";"4";"0";"7";"1";"0";"0";"0";"1";"8";"Alessandria";""
"2014";" 006188 ";"VOLPEDO";"PIAZZA LIBERTA'";"Mercato";"dom.";"Settimanale";"Annuale";"0";"5";"5";"0";"10";"0";"10";"10";"1";"21";"31";"Alessandria";""
"2014";" 096018 ";"CERRIONE";"PIAZZA QUINTINO SELLA";"Mercato";"ven.";"Settimanale";"Annuale";"0";"5";"4";"0";"9";"0";"1";"0";"0";"1";"10";"Biella";""
"2014";" 096057 ";"SALA BIELLESE";"PIAZZA VITTORIO EMANUELE II";"Mercato";"ven.";"Settimanale";"Annuale";"0";"1";"1";"0";"2";"0";"0";"0";"0";"0";"2";"Biella";""
"2014";" 096065 ";"STRONA";"FRAZIONE FONTANELLA OZINO";"Mercato";"ven.";"Settimanale";"Annuale";"0";"2";"0";"0";"2";"0";"0";"0";"0";"0";"2";"Biella";""
"2014";" 096068 ";"TOLLEGNO";"VIA GRAMSCI LOCALITA' FILATURA";"Posteggio isolato";"gio.";"Settimanale";"Annuale";"0";"1";"0";"0";"1";"0";"0";"0";"0";"0";"1";"Biella";""
"2014";" 096071 ";"VALDENGO";"PIAZZA FONDO EDO TEMPIA";"Mercato";"gio.";"Settimanale";"Annuale";"0";"5";"5";"0";"10";"0";"2";"5";"0";"7";"17";"Biella";""
"2014";" 096076 ";"VERRONE";"PIAZZA ALPINI D'ITALIA";"Mercato";"gio.";"Settimanale";"Annuale";"3";"0";"0";"0";"3";"10";"0";"0";"0";"10";"13";"Biella";""
"2014";" 096077 ";"VIGLIANO BIELLESE";"VIA QUINTINO SELLA";"Posteggio isolato";"lun. mar. mer. gio. ven. sab. dom.";"Settimanale";"Annuale";"1";"0";"0";"0";"1";"0";"0";"0";"0";"0";"1";"Biella";""
"2014";" 103019 ";"CASALE CORTE CERRO";"P.ZZA MERCATO-VIA MARCONI-VIA RAMATE";"Mercato";"mer.";"Settimanale";"Annuale";"0";"1";"2";"0";"3";"3";"1";"0";"0";"4";"7";"Verbano Cusio Ossola";""
"2014";" 103057 ";"PREMOSELLO-CHIOVENDA";"PIAZZA BOLZANI";"Mercato";"gio.";"Settimanale";"Annuale";"0";"4";"8";"0";"12";"0";"0";"0";"0";"0";"12";"Verbano Cusio Ossola";""
"2014";" 103072 ";"VERBANIA";"PIAZZA MERCATO";"Mercato";"sab.";"Settimanale";"Annuale";"0";"26";"186";"4";"216";"0";"0";"4";"1";"5";"221";"Verbano Cusio Ossola";""
"2014";" 103074 ";"VIGNONE";"PIAZZA DANTE";"Mercato";"mar.";"Settimanale";"Annuale";"0";"0";"0";"0";"0";"3";"3";"3";"3";"12";"12";"Verbano Cusio Ossola";""
"2014";" 096068 ";"TOLLEGNO";"PIAZZA PINI D'ITALIA - TOLLEGNO";"Mercato";"gio. sab.";"Settimanale";"Annuale";"0";"3";"6";"0";"9";"0";"0";"0";"0";"0";"9";"Biella";""
"2014";" 103006 ";"BACENO";"PIAZZA ALDO MORO";"Mercato";"mer.";"Settimanale";"Annuale";"0";"2";"6";"0";"8";"0";"0";"2";"1";"3";"11";"Verbano Cusio Ossola";""
"2014";" 103008 ";"BAVENO";"PIAZZA MAZZINI OLTREFIUME";"Posteggio isolato";"ven.";"Settimanale";"Annuale";"0";"1";"0";"0";"1";"0";"0";"0";"0";"0";"1";"Verbano Cusio Ossola";""
"2014";" 103027 ";"CURSOLO-ORASSO";"Piazza Vittorio Emanuele, 6 - Cursolo";"Mercato";"gio.";"Quindicinale";"Annuale";"0";"1";"0";"1";"2";"0";"1";"0";"1";"2";"4";"Verbano Cusio Ossola";""
"2014";" 103052 ";"PALLANZENO";"PIAZZA MUNICIPIO";"Mercato";"ven.";"Settimanale";"Annuale";"0";"0";"2";"0";"2";"0";"0";"0";"0";"0";"2";"Verbano Cusio Ossola";""
"2014";" 096055 ";"ROSAZZA";"Piazza Vitale Rosazza";"Mercato";"mar.";"Settimanale";"Stagionale";"1";"1";"1";"1";"4";"0";"0";"0";"0";"0";"4";"Biella";""
"2014";" 103028 ";"DOMODOSSOLA";"VIA ROSMINI - P.ZZA MERCATO - VIA OSCI - VIA BELTRAMI - P.ZZA CONVENZIONE PIAZZA REPUBBLICA DELL'OSSOLA VIA GARIBALDI PIAZZA TIBALDI";"Mercato";"sab.";"Settimanale";"Annuale";"0";"15";"158";"0";"173";"0";"3";"18";"0";"21";"194";"Verbano Cusio Ossola";""
"2014";" 103036 ";"GURRO";"PIAZZA DELLA REPUBBLICA";"Mercato";"ven.";"Settimanale";"Annuale";"1";"0";"1";"0";"2";"3";"0";"0";"0";"3";"5";"Verbano Cusio Ossola";""
"2014";" 103041 ";"MALESCO";"PIAZZA XV MARTIRI";"Mercato";"mar.";"Settimanale";"Annuale";"0";"7";"21";"2";"30";"0";"3";"2";"2";"7";"37";"Verbano Cusio Ossola";""
"2014";" 096084 ";"MOSSO";"Piazza Italia";"Mercato";"lun.";"Settimanale";"Annuale";"1";"8";"10";"0";"19";"0";"1";"1";"1";"3";"22";"Biella";""
"2014";" 103017 ";"CANNOBIO";"PIAZZA VITTORIO EMENUELE III - VIA MAGISTRIS - PIAZZA MARTIRI DELLA LIBERTA'";"Mercato";"dom.";"Settimanale";"Annuale";"0";"23";"163";"0";"186";"0";"0";"0";"0";"0";"186";"Verbano Cusio Ossola";""
"2014";" 103064 ";"STRESA";"Via Per Stropino - Frazione Magognino";"Posteggio isolato";"mer.";"Settimanale";"Annuale";"0";"0";"0";"0";"0";"0";"0";"1";"0";"1";"1";"Verbano Cusio Ossola";""
"2014";" 103066 ";"TRAREGO VIGGIONA";"PIAZZA CADORNA";"Mercato";"mer.";"Settimanale";"Annuale";"0";"1";"0";"0";"1";"0";"1";"4";"0";"5";"6";"Verbano Cusio Ossola";""
"2014";" 096073 ";"VALLE MOSSO";"Piazza Chiesa";"Mercato";"gio.";"Settimanale";"Annuale";"0";"3";"2";"0";"5";"0";"0";"0";"0";"0";"5";"Biella";""
"2014";" 096077 ";"VIGLIANO BIELLESE";"VIA LARGO STAZIONE";"Mercato";"mar.";"Settimanale";"Annuale";"0";"14";"25";"0";"39";"0";"2";"3";"2";"7";"46";"Biella";""
"2014";" 096063 ";"SORDEVOLO";"PIAZZA VITTORIO VENETO";"Mercato";"lun.";"Settimanale";"Annuale";"0";"1";"2";"1";"4";"0";"0";"0";"0";"0";"4";"Biella";""
"2014";" 096080 ";"VIVERONE";"Localitï¿½ Moncanino";"Mercato";"dom.";"Settimanale";"Annuale";"0";"3";"6";"3";"12";"0";"5";"12";"1";"18";"30";"Biella";""
"2014";" 103026 ";"CRODO";"Piazza DON LORENZO FRANCIONE";"Mercato";"ven.";"Settimanale";"Annuale";"0";"2";"6";"0";"8";"0";"0";"0";"2";"2";"10";"Verbano Cusio Ossola";""
"2014";" 103030 ";"FALMENTA";"PIAZZALE DELLE CORRIERE";"Mercato";"gio.";"Settimanale";"Annuale";"0";"2";"0";"0";"2";"0";"0";"0";"0";"0";"2";"Verbano Cusio Ossola";""
"2014";" 103044 ";"MERGOZZO";"PIAZZA DELLA RESISTENZA";"Mercato";"mar.";"Settimanale";"Annuale";"0";"5";"7";"0";"12";"0";"2";"0";"1";"3";"15";"Verbano Cusio Ossola";""
"2014";" 103060 ";"RE";"PIAZZALE SERENELLA";"Mercato";"sab.";"Settimanale";"Annuale";"3";"2";"3";"0";"8";"0";"0";"0";"0";"0";"8";"Verbano Cusio Ossola";""
"2014";" 103062 ";"SANTA MARIA MAGGIORE";"VIA GIACOMO MATTEOTTI";"Mercato";"lun.";"Settimanale";"Stagionale";"0";"8";"53";"4";"65";"0";"0";"0";"1";"1";"66";"Verbano Cusio Ossola";""
"2014";" 096053 ";"RONCO BIELLESE";"LARGO CARLO GAGLIAZZO";"Mercato";"ven.";"Settimanale";"Annuale";"0";"3";"0";"1";"4";"0";"0";"0";"0";"0";"4";"Biella";""
"2014";" 103042 ";"MASERA";"Piazzale DOn Giovanni Mora";"Mercato";"mer.";"Settimanale";"Annuale";"0";"3";"6";"2";"11";"0";"1";"0";"0";"1";"12";"Verbano Cusio Ossola";""
"2014";" 103050 ";"OMEGNA";"PIAZZA VITTORIO VENETO";"Mercato";"sab.";"Settimanale";"Annuale";"0";"3";"4";"1";"8";"0";"0";"0";"0";"0";"8";"Verbano Cusio Ossola";""
"2014";" 103072 ";"VERBANIA";"PIAZZA GARIBALDI";"Mercato";"ven.";"Settimanale";"Annuale";"0";"9";"36";"1";"46";"0";"3";"5";"0";"8";"54";"Verbano Cusio Ossola";""
"2014";" 096050 ";"PRAY";"PIAZZA A. LORA TOTINO";"Mercato";"gio.";"Settimanale";"Annuale";"0";"8";"12";"5";"25";"0";"4";"5";"0";"9";"34";"Biella";""
"2014";" 096058 ";"SALUSSOLA";"via Elvo s.n.c.";"Mercato";"sab.";"Settimanale";"Annuale";"0";"1";"0";"0";"1";"0";"4";"2";"0";"6";"7";"Biella";""
"2014";" 096064 ";"SOSTEGNO";"CORSO ALFIERI";"Posteggio isolato";"gio.";"Settimanale";"Annuale";"0";"1";"0";"0";"1";"0";"0";"0";"0";"0";"1";"Biella";""
"2014";" 096070 ";"TRIVERO";"Piazza Chiesa";"Mercato";"sab.";"Settimanale";"Annuale";"0";"3";"0";"0";"3";"0";"1";"4";"1";"6";"9";"Biella";""
"2014";" 096077 ";"VIGLIANO BIELLESE";"VIA QUINTINO SELLA";"Posteggio isolato";"lun. mar. mer. gio. ven. sab. dom.";"Settimanale";"Annuale";"1";"0";"0";"0";"1";"0";"0";"0";"0";"0";"1";"Biella";""
"2014";" 103028 ";"DOMODOSSOLA";"PIAZZA MERCATO";"Mercato";"lun. mar. mer. gio. ven.";"Settimanale";"Annuale";"0";"5";"1";"0";"6";"0";"0";"0";"0";"0";"6";"Verbano Cusio Ossola";""
"2014";" 103041 ";"MALESCO";"PIAZZA XV MARTIRI";"Mercato";"mar.";"Settimanale";"Stagionale";"0";"7";"45";"2";"54";"0";"1";"1";"2";"4";"58";"Verbano Cusio Ossola";""
"2014";" 103054 ";"PIEVE VERGONTE";"Piazza Mercato";"Mercato";"mer.";"Settimanale";"Annuale";"0";"4";"1";"0";"5";"0";"4";"13";"2";"19";"24";"Verbano Cusio Ossola";""
"2014";" 103055 ";"PREMENO";"Piazza C. Battisti";"Mercato";"gio.";"Settimanale";"Annuale";"3";"0";"0";"0";"3";"3";"0";"0";"0";"3";"6";"Verbano Cusio Ossola";""
"2014";" 103062 ";"SANTA MARIA MAGGIORE";"VIA GIACOMO MATTEOTTI";"Mercato";"lun.";"Settimanale";"Stagionale";"0";"0";"5";"0";"5";"0";"2";"3";"0";"5";"10";"Verbano Cusio Ossola";""
"2014";" 103064 ";"STRESA";"Isola Pescatori";"Mercato";"lun. mar. mer. gio. ven. sab. dom.";"Settimanale";"Annuale";"0";"0";"8";"0";"8";"0";"0";"0";"0";"0";"8";"Verbano Cusio Ossola";""
"2014";" 103075 ";"VILLADOSSOLA";"PIAZZA REPUBBLICA";"Mercato";"ven.";"Settimanale";"Annuale";"0";"0";"0";"0";"0";"0";"3";"0";"0";"3";"3";"Verbano Cusio Ossola";""
"2014";" 103075 ";"VILLADOSSOLA";"PIAZZA REPUBBLICA";"Mercato";"mar.";"Settimanale";"Annuale";"0";"14";"35";"0";"49";"0";"2";"1";"1";"4";"53";"Verbano Cusio Ossola";""
"2014";" 096073 ";"VALLE MOSSO";"Piazza Martiri della Liberta'";"Mercato";"sab.";"Settimanale";"Annuale";"0";"5";"3";"0";"8";"0";"2";"4";"1";"7";"15";"Biella";""
"2014";" 096076 ";"VERRONE";"Piazza Alpini";"Posteggio isolato";"gio.";"Settimanale";"Annuale";"0";"0";"1";"0";"1";"0";"0";"0";"0";"0";"1";"Biella";""
"2014";" 103012 ";"BOGNANCO";"SAN LORENZO";"Mercato";"mar.";"Settimanale";"Stagionale";"0";"0";"0";"0";"0";"3";"0";"0";"2";"5";"5";"Verbano Cusio Ossola";""
"2014";" 103029 ";"DRUOGNO";"PIAZZALE COLONIA";"Mercato";"gio.";"Settimanale";"Stagionale";"0";"7";"27";"0";"34";"0";"0";"3";"2";"5";"39";"Verbano Cusio Ossola";""
"2014";" 103064 ";"STRESA";"Piazza Della Minola - Frazione Someraro";"Posteggio isolato";"mer.";"Settimanale";"Annuale";"0";"0";"0";"0";"0";"0";"0";"1";"0";"1";"1";"Verbano Cusio Ossola";""
"2014";" 103064 ";"STRESA";"Via P.pe Tomaso angolo Via Roma";"Posteggio isolato";"lun. mar. mer. gio. ven. sab. dom.";"Settimanale";"Stagionale";"0";"0";"1";"0";"1";"0";"0";"0";"0";"0";"1";"Verbano Cusio Ossola";""
"2014";" 096056 ";"SAGLIANO MICCA";"PIAZZA PIETRO MICCA";"Mercato";"ven.";"Settimanale";"Annuale";"0";"1";"1";"0";"2";"0";"9";"4";"2";"15";"17";"Biella";""
"2014";" 096059 ";"SANDIGLIANO";"Piazza San Giovanni Cottolengo";"Mercato";"mer.";"Settimanale";"Annuale";"0";"4";"1";"1";"6";"0";"3";"3";"0";"6";"12";"Biella";""
"2014";" 096070 ";"TRIVERO";"Fraz. Ponzone";"Mercato";"mer.";"Settimanale";"Annuale";"0";"13";"23";"0";"36";"0";"3";"7";"1";"11";"47";"Biella";""
"2014";" 103001 ";"ANTRONA SCHIERANCO";"PIAZZA MERCATO";"Mercato";"mer.";"Settimanale";"Stagionale";"0";"0";"6";"0";"6";"0";"0";"4";"0";"4";"10";"Verbano Cusio Ossola";""
"2014";" 103003 ";"ARIZZANO";"PIAZZA GROPPALLO";"Posteggio isolato";"lun.";"Settimanale";"Annuale";"0";"0";"0";"0";"0";"1";"0";"0";"0";"1";"1";"Verbano Cusio Ossola";""
"2014";" 103008 ";"BAVENO";"VIA MAZZINI";"Mercato";"gio.";"Settimanale";"Stagionale";"0";"0";"20";"0";"20";"0";"0";"0";"0";"0";"20";"Verbano Cusio Ossola";""
"2014";" 103016 ";"CANNERO RIVIERA";"PIAZZA ALPINI";"Mercato";"ven.";"Settimanale";"Annuale";"0";"4";"7";"0";"11";"0";"0";"4";"0";"4";"15";"Verbano Cusio Ossola";""
"2014";" 103039 ";"MACUGNAGA";"PIAZZALE TAMBACH";"Mercato";"ven.";"Settimanale";"Stagionale";"0";"7";"30";"2";"39";"0";"2";"3";"2";"7";"46";"Verbano Cusio Ossola";""
"2014";" 103064 ";"STRESA";"Piazza San Carlo";"Posteggio isolato";"gio.";"Settimanale";"Annuale";"0";"0";"1";"0";"1";"0";"0";"0";"0";"0";"1";"Verbano Cusio Ossola";""
"2014";" 103064 ";"STRESA";"Piazza Monte Grappa - Frazione Levo";"Posteggio isolato";"mer.";"Settimanale";"Annuale";"0";"0";"0";"0";"0";"0";"0";"1";"0";"1";"1";"Verbano Cusio Ossola";""
"2014";" 103072 ";"VERBANIA";"TROBASO- PIAZZA PARRI";"Mercato";"mar.";"Settimanale";"Annuale";"0";"2";"1";"0";"3";"0";"5";"5";"0";"10";"13";"Verbano Cusio Ossola";""
"2014";" 096080 ";"VIVERONE";"PIAZZALE LOCALITA' BECCO - VIALE LUNGO LAGO";"Mercato";"dom.";"Settimanale";"Stagionale";"0";"0";"5";"0";"5";"0";"0";"4";"0";"4";"9";"Biella";""
"2014";" 103008 ";"BAVENO";"VIA 17 MARTIRI";"Mercato";"lun.";"Settimanale";"Annuale";"0";"10";"46";"1";"57";"0";"1";"16";"0";"17";"74";"Verbano Cusio Ossola";""
"2014";" 103031 ";"FORMAZZA";"Frazione Valdo presso campo sportivo";"Mercato";"gio.";"Settimanale";"Annuale";"0";"0";"5";"0";"5";"0";"0";"0";"2";"2";"7";"Verbano Cusio Ossola";""
"2014";" 103050 ";"OMEGNA";"PIAZZA MARTIRI - VIA GRAMSCI";"Mercato";"gio.";"Settimanale";"Annuale";"0";"26";"127";"3";"156";"0";"0";"0";"0";"0";"156";"Verbano Cusio Ossola";""
"2014";" 103064 ";"STRESA";"Piazza Monte Grappa - Frazione Levo";"Posteggio isolato";"mar.";"Settimanale";"Annuale";"0";"0";"0";"0";"0";"0";"0";"1";"0";"1";"1";"Verbano Cusio Ossola";""
"2014";" 096054 ";"ROPPOLO";"area mercatale";"Posteggio isolato";"ven.";"Settimanale";"Annuale";"0";"1";"0";"0";"1";"0";"0";"0";"0";"0";"1";"Biella";""
"2014";" 096058 ";"SALUSSOLA";"PIAZZA DON UMBERTO GIBELLATO";"Mercato";"lun.";"Settimanale";"Annuale";"0";"2";"4";"0";"6";"0";"0";"0";"0";"0";"6";"Biella";""
"2014";" 096070 ";"TRIVERO";"Pratrivero - Guppo di posteggi";"Mercato";"mar.";"Settimanale";"Annuale";"0";"0";"0";"0";"0";"0";"3";"1";"0";"4";"4";"Biella";""
"2014";" 103012 ";"BOGNANCO";"Via Cavallini";"Mercato";"gio.";"Settimanale";"Stagionale";"0";"0";"1";"0";"1";"0";"2";"0";"1";"3";"4";"Verbano Cusio Ossola";""
"2014";" 103014 ";"CALASCA-CASTIGLIONE";"Antrogna";"Mercato";"mer.";"Settimanale";"Annuale";"0";"0";"1";"0";"1";"0";"1";"1";"0";"2";"3";"Verbano Cusio Ossola";""
"2014";" 103024 ";"CRAVEGGIA";"piazza san Giacomo";"Posteggio isolato";"mer. sab.";"Settimanale";"Stagionale";"0";"0";"0";"0";"0";"0";"1";"0";"0";"1";"1";"Verbano Cusio Ossola";""
"2014";" 103064 ";"STRESA";"PIAZZA CAPUCCI";"Mercato";"ven.";"Settimanale";"Annuale";"0";"6";"52";"2";"60";"7";"1";"0";"0";"8";"68";"Verbano Cusio Ossola";""
"2014";" 103064 ";"STRESA";"Frazione Isola Bella";"Mercato";"lun. mar. mer. gio. ven. sab. dom.";"Settimanale";"Annuale";"0";"0";"13";"0";"13";"0";"0";"0";"0";"0";"13";"Verbano Cusio Ossola";""
"2014";" 096054 ";"ROPPOLO";"area mercatale";"Posteggio isolato";"ven.";"Settimanale";"Annuale";"0";"1";"0";"0";"1";"0";"0";"0";"0";"0";"1";"Biella";""
"2014";" 103003 ";"ARIZZANO";"V. Firenze - FRAZIONE CISSANO";"Posteggio isolato";"lun. ven.";"Settimanale";"Annuale";"0";"0";"0";"0";"0";"1";"0";"0";"0";"1";"1";"Verbano Cusio Ossola";""
"2014";" 103007 ";"BANNIO ANZINO";"PIAZZA COCCHINETTI";"Posteggio isolato";"mer.";"Settimanale";"Stagionale";"0";"0";"1";"0";"1";"0";"0";"0";"0";"0";"1";"Verbano Cusio Ossola";""
"2014";" 103029 ";"DRUOGNO";"PIAZZA MUNICIPIO";"Mercato";"gio.";"Settimanale";"Stagionale";"0";"3";"3";"0";"6";"2";"0";"0";"0";"2";"8";"Verbano Cusio Ossola";""
"2014";" 103034 ";"GIGNESE";"PIAZZA ALPINI D'ITALIA";"Mercato";"mar.";"Settimanale";"Annuale";"0";"2";"4";"0";"6";"0";"0";"0";"0";"0";"6";"Verbano Cusio Ossola";""
"2014";" 103044 ";"MERGOZZO";"PIAZZA FONTANA BRACCHIO";"Posteggio isolato";"ven.";"Settimanale";"Annuale";"0";"0";"0";"0";"0";"0";"1";"0";"0";"1";"1";"Verbano Cusio Ossola";""
"2014";" 103059 ";"QUARNA SOTTO";"PIAZZA SANTA RITA";"Mercato";"sab.";"Settimanale";"Annuale";"0";"4";"2";"0";"6";"0";"0";"0";"0";"0";"6";"Verbano Cusio Ossola";""
"2014";" 103064 ";"STRESA";"Via Per Magognino - Frazione Brisino";"Posteggio isolato";"mer.";"Settimanale";"Annuale";"0";"0";"0";"0";"0";"0";"0";"1";"0";"1";"1";"Verbano Cusio Ossola";""
"2014";" 103076 ";"VILLETTE";"VIA AI MONTI";"Mercato";"gio.";"Settimanale";"Annuale";"0";"1";"1";"0";"2";"0";"1";"1";"0";"2";"4";"Verbano Cusio Ossola";""
"2014";" 103077 ";"VOGOGNA";"PIAZZA DON ANGELO AIROLDI";"Mercato";"ven.";"Settimanale";"Annuale";"0";"4";"6";"0";"10";"0";"1";"5";"2";"8";"18";"Verbano Cusio Ossola";""
"2014";" 096054 ";"ROPPOLO";"PIAZZA MERCATO";"Mercato";"ven.";"Settimanale";"Annuale";"0";"2";"1";"0";"3";"5";"3";"4";"1";"13";"16";"Biella";""
"2014";" 103035 ";"GRAVELLONA TOCE";"VIA CORRIDONI";"Mercato";"mer.";"Settimanale";"Annuale";"0";"5";"40";"1";"46";"0";"5";"7";"2";"14";"60";"Verbano Cusio Ossola";""
"2014";" 103051 ";"ORNAVASSO";"piazza XXIV Maggio";"Mercato";"lun.";"Settimanale";"Annuale";"0";"9";"18";"0";"27";"0";"3";"14";"0";"17";"44";"Verbano Cusio Ossola";""
"2014";" 103053 ";"PIEDIMULERA";"VIA STAZIONE - PIAZZA MORANDINI";"Mercato";"lun.";"Settimanale";"Annuale";"0";"1";"1";"0";"2";"0";"5";"15";"1";"21";"23";"Verbano Cusio Ossola";""
"2014";" 103072 ";"VERBANIA";"PALLANZA";"Mercato";"ven.";"Settimanale";"Stagionale";"0";"2";"44";"4";"50";"0";"0";"8";"0";"8";"58";"Verbano Cusio Ossola";""
"2014";" 096050 ";"PRAY";"VIA GARIBALDI";"Posteggio isolato";"lun.";"Settimanale";"Annuale";"0";"0";"0";"0";"0";"0";"0";"1";"0";"1";"1";"Biella";""
"2014";" 103009 ";"BEE";"PIAZZA BAROZZI";"Posteggio isolato";"mar.";"Settimanale";"Annuale";"0";"1";"0";"0";"1";"0";"0";"0";"0";"0";"1";"Verbano Cusio Ossola";""
"2014";" 103065 ";"TOCENO";"piazza della chiesa";"Mercato";"mer.";"Settimanale";"Stagionale";"0";"3";"21";"0";"24";"0";"0";"0";"0";"0";"24";"Verbano Cusio Ossola";""
"2014";" 103072 ";"VERBANIA";"VIA MOTTA FIUME";"Mercato";"gio.";"Settimanale";"Annuale";"0";"0";"0";"10";"10";"0";"0";"0";"5";"5";"15";"Verbano Cusio Ossola";""
"2014";" 103075 ";"VILLADOSSOLA";"PIAZZA MOTTA LOCALITA' VILLAGGIO";"Mercato";"gio.";"Settimanale";"Annuale";"0";"1";"0";"0";"1";"0";"1";"1";"0";"2";"3";"Verbano Cusio Ossola";""
"2014";" 096083 ";"ZUMAGLIA";"VIA ROMA / GIARDINI";"Mercato";"mer.";"Settimanale";"Annuale";"0";"2";"0";"0";"2";"0";"0";"0";"0";"0";"2";"Biella";""
"2014";" 103024 ";"CRAVEGGIA";"Piazza Mercato";"Mercato";"ven.";"Settimanale";"Annuale";"1";"1";"8";"0";"10";"3";"2";"5";"2";"12";"22";"Verbano Cusio Ossola";""
"2014";" 103055 ";"PREMENO";"VIA TRESOLDI LORINI";"Mercato";"gio.";"Settimanale";"Annuale";"0";"2";"17";"0";"19";"0";"0";"4";"0";"4";"23";"Verbano Cusio Ossola";""
"2014";" 103071 ";"VARZO";"PIAZZA TRIESTE";"Mercato";"gio.";"Settimanale";"Annuale";"0";"4";"8";"1";"13";"0";"0";"2";"1";"3";"16";"Verbano Cusio Ossola";""
